5 Minutes,Lane 1 Flow (Veh/5 Minutes),Lane 1 Speed (mph),Lane 2 Flow (Veh/5 Minutes),Lane 2 Speed (mph),Flow (Veh/5 Minutes),Speed (mph),# Lane Points,% Observed
12/25/2017 0:00,10,69.3,26,64.7,36,66,2,0
12/25/2017 0:05,15,69.3,31,64.7,46,66.2,2,0
12/25/2017 0:10,15,69.4,30,64.8,45,66.3,2,0
12/25/2017 0:15,16,68.9,31,64.2,47,65.8,2,0
12/25/2017 0:20,11,69.1,26,64.5,37,65.9,2,0
12/25/2017 0:25,11,69.2,26,64.6,37,66,2,0
12/25/2017 0:30,13,69.2,29,64.6,42,66.1,2,0
12/25/2017 0:35,11,69.4,27,64.8,38,66.1,2,0
12/25/2017 0:40,9,69.3,24,64.7,33,66,2,0
12/25/2017 0:45,11,69.4,26,64.7,37,66.1,2,0
12/25/2017 0:50,13,69.3,28,64.7,41,66.2,2,0
12/25/2017 0:55,8,69.4,23,64.8,31,66,2,0
12/25/2017 1:00,10,69.4,26,64.8,36,66.1,2,0
12/25/2017 1:05,8,69.4,23,64.8,31,66,2,0
12/25/2017 1:10,8,69.3,23,64.7,31,65.9,2,0
12/25/2017 1:15,10,69.3,25,64.7,35,66.1,2,0
12/25/2017 1:20,7,69.3,22,64.7,29,65.8,2,0
12/25/2017 1:25,6,69.4,22,64.8,28,65.8,2,0
12/25/2017 1:30,8,69.4,24,64.8,32,65.9,2,0
12/25/2017 1:35,6,69.4,21,64.8,27,65.9,2,0
12/25/2017 1:40,9,69.3,24,64.7,33,66,2,0
12/25/2017 1:45,7,69.4,23,64.8,30,65.8,2,0
12/25/2017 1:50,6,69.3,22,64.7,28,65.7,2,0
12/25/2017 1:55,8,69.3,24,64.7,32,65.9,2,0
12/25/2017 2:00,15,69.3,22,64.7,37,66.6,2,0
12/25/2017 2:05,10,69.3,25,64.7,35,66.1,2,0
12/25/2017 2:10,12,69.4,21,64.8,33,66.4,2,0
12/25/2017 2:15,6,69.3,21,64.7,27,65.8,2,0
12/25/2017 2:20,4,69.3,19,64.7,23,65.5,2,0
12/25/2017 2:25,8,69.4,23,64.8,31,66,2,0
12/25/2017 2:30,6,69.4,22,64.8,28,65.8,2,0
12/25/2017 2:35,5,69.4,21,64.8,26,65.7,2,0
12/25/2017 2:40,6,69.4,21,64.8,27,65.9,2,0
12/25/2017 2:45,7,69.4,22,64.8,29,65.9,2,0
12/25/2017 2:50,13,69.4,21,64.8,34,66.6,2,0
12/25/2017 2:55,7,69.4,22,64.8,29,66,2,0
12/25/2017 3:00,10,69.4,20,64.8,30,66.4,2,0
12/25/2017 3:05,8,69.4,24,64.8,32,66,2,0
12/25/2017 3:10,6,69.4,22,64.8,28,65.8,2,0
12/25/2017 3:15,11,69.4,21,64.8,32,66.4,2,0
12/25/2017 3:20,5,69.3,21,64.7,26,65.6,2,0
12/25/2017 3:25,5,69.3,21,64.7,26,65.6,2,0
12/25/2017 3:30,6,69.4,21,64.8,27,65.8,2,0
12/25/2017 3:35,5,69.3,21,64.7,26,65.6,2,0
12/25/2017 3:40,6,69.3,21,64.7,27,65.8,2,0
12/25/2017 3:45,7,69.4,22,64.8,29,65.9,2,0
12/25/2017 3:50,6,69.4,21,64.8,27,65.9,2,0
12/25/2017 3:55,11,69.4,21,64.8,32,66.4,2,0
12/25/2017 4:00,6,69.4,22,64.8,28,65.8,2,0
12/25/2017 4:05,7,69.4,22,64.8,29,65.9,2,0
12/25/2017 4:10,5,69.4,20,64.8,25,65.7,2,0
12/25/2017 4:15,8,69.3,24,64.7,32,65.8,2,0
12/25/2017 4:20,10,69.3,25,64.7,35,66,2,0
12/25/2017 4:25,10,69.4,25,64.8,35,66.1,2,0
12/25/2017 4:30,6,69.4,21,64.8,27,65.8,2,0
12/25/2017 4:35,8,69.3,24,64.7,32,65.9,2,0
12/25/2017 4:40,8,69.4,23,64.8,31,66,2,0
12/25/2017 4:45,6,69.4,21,64.8,27,65.8,2,0
12/25/2017 4:50,8,69.4,24,64.8,32,65.9,2,0
12/25/2017 4:55,8,69.4,23,64.8,31,66,2,0
12/25/2017 5:00,10,69.4,25,64.8,35,66.1,2,0
12/25/2017 5:05,7,69.4,22,64.8,29,65.9,2,0
12/25/2017 5:10,7,69.4,22,64.8,29,65.9,2,0
12/25/2017 5:15,7,69.3,23,64.7,30,65.8,2,0
12/25/2017 5:20,8,69.3,23,64.7,31,65.9,2,0
12/25/2017 5:25,9,69.4,24,64.8,33,66.1,2,0
12/25/2017 5:30,11,69.5,26,64.9,37,66.2,2,0
12/25/2017 5:35,9,69.4,24,64.8,33,66.1,2,0
12/25/2017 5:40,10,69.4,25,64.8,35,66.1,2,0
12/25/2017 5:45,12,69.4,27,64.8,39,66.2,2,0
12/25/2017 5:50,15,69.5,30,64.9,45,66.4,2,0
12/25/2017 5:55,9,69.4,24,64.8,33,66,2,0
12/25/2017 6:00,11,69.5,26,64.9,37,66.3,2,0
12/25/2017 6:05,9,69.5,24,64.9,33,66.1,2,0
12/25/2017 6:10,9,69.5,24,64.9,33,66.2,2,0
12/25/2017 6:15,9,69.5,24,64.9,33,66.1,2,0
12/25/2017 6:20,11,69.5,26,64.9,37,66.3,2,0
12/25/2017 6:25,9,69.4,25,64.8,34,66.1,2,0
12/25/2017 6:30,9,69.4,25,64.8,34,66,2,0
12/25/2017 6:35,10,69.5,25,64.9,35,66.2,2,0
12/25/2017 6:40,11,69.4,26,64.8,37,66.2,2,0
12/25/2017 6:45,11,69.4,27,64.8,38,66.1,2,0
12/25/2017 6:50,13,69.4,28,64.8,41,66.3,2,0
12/25/2017 6:55,15,69.5,30,64.9,45,66.4,2,0
12/25/2017 7:00,10,69.3,26,64.7,36,65.9,2,0
12/25/2017 7:05,15,69.2,31,64.6,46,66.1,2,0
12/25/2017 7:10,17,69.4,32,64.8,49,66.4,2,0
12/25/2017 7:15,17,69.3,33,64.7,50,66.3,2,0
12/25/2017 7:20,16,69.4,32,64.8,48,66.3,2,0
12/25/2017 7:25,16,69.3,32,64.7,48,66.2,2,0
12/25/2017 7:30,15,69.4,31,64.8,46,66.3,2,0
12/25/2017 7:35,17,69.5,32,64.9,49,66.5,2,0
12/25/2017 7:40,15,69.4,30,64.8,45,66.4,2,0
12/25/2017 7:45,17,69.5,33,64.9,50,66.4,2,0
12/25/2017 7:50,14,69.4,30,64.8,44,66.2,2,0
12/25/2017 7:55,13,69.3,28,64.7,41,66.2,2,0
12/25/2017 8:00,13,69.4,28,64.7,41,66.2,2,0
12/25/2017 8:05,14,69.3,29,64.7,43,66.2,2,0
12/25/2017 8:10,13,69.4,28,64.8,41,66.2,2,0
12/25/2017 8:15,12,69.3,28,64.7,40,66.1,2,0
12/25/2017 8:20,13,69.3,28,64.7,41,66.1,2,0
12/25/2017 8:25,20,69.3,36,64.7,56,66.4,2,0
12/25/2017 8:30,15,69.4,31,64.8,46,66.3,2,0
12/25/2017 8:35,15,69.4,31,64.8,46,66.3,2,0
12/25/2017 8:40,18,69.4,33,64.8,51,66.4,2,0
12/25/2017 8:45,16,69.3,31,64.7,47,66.2,2,0
12/25/2017 8:50,19,68.8,35,64.2,54,65.8,2,0
12/25/2017 8:55,19,69.1,34,64.5,53,66.2,2,0
12/25/2017 9:00,14,69.3,31,64.7,45,66.1,2,0
12/25/2017 9:05,19,69,35,64.4,54,66,2,0
12/25/2017 9:10,17,69.3,34,64.7,51,66.2,2,0
12/25/2017 9:15,17,69.2,33,64.6,50,66.2,2,0
12/25/2017 9:20,20,69.3,36,64.7,56,66.3,2,0
12/25/2017 9:25,18,69.2,34,64.6,52,66.2,2,0
12/25/2017 9:30,22,69.3,37,64.7,59,66.4,2,0
12/25/2017 9:35,20,69.3,36,64.7,56,66.4,2,0
12/25/2017 9:40,24,69.3,39,64.7,63,66.5,2,0
12/25/2017 9:45,29,69.6,45,65,74,66.8,2,0
12/25/2017 9:50,26,69.8,42,65.3,68,67,2,0
12/25/2017 9:55,23,69.7,40,65.1,63,66.8,2,0
12/25/2017 10:00,24,70.1,40,65.5,64,67.2,2,0
12/25/2017 10:05,29,70.5,45,66,74,67.7,2,0
12/25/2017 10:10,33,71,50,66.5,83,68.3,2,0
12/25/2017 10:15,31,71.2,47,66.8,78,68.5,2,0
12/25/2017 10:20,38,71.5,55,67,93,68.9,2,0
12/25/2017 10:25,36,72.1,52,67.7,88,69.5,2,0
12/25/2017 10:30,37,71.6,54,67.1,91,68.9,2,0
12/25/2017 10:35,43,70.5,60,65.8,103,67.8,2,0
12/25/2017 10:40,44,71.3,61,66.8,105,68.7,2,0
12/25/2017 10:45,45,72.1,62,67.7,107,69.5,2,0
12/25/2017 10:50,39,72.1,56,67.7,95,69.5,2,0
12/25/2017 10:55,43,72.8,59,68.4,102,70.3,2,0
12/25/2017 11:00,44,72.7,61,68.3,105,70.2,2,0
12/25/2017 11:05,49,72.4,66,68,115,69.9,2,0
12/25/2017 11:10,49,73.2,67,68.9,116,70.7,2,0
12/25/2017 11:15,43,73.1,60,68.7,103,70.5,2,0
12/25/2017 11:20,51,72.9,69,68.6,120,70.4,2,0
12/25/2017 11:25,49,72.7,67,68.3,116,70.2,2,0
12/25/2017 11:30,43,73,61,68.6,104,70.4,2,0
12/25/2017 11:35,44,73,61,68.6,105,70.5,2,0
12/25/2017 11:40,39,72.7,56,68.3,95,70.1,2,0
12/25/2017 11:45,44,72.8,61,68.4,105,70.3,2,0
12/25/2017 11:50,41,72.7,58,68.3,99,70.2,2,0
12/25/2017 11:55,38,72.8,54,68.4,92,70.2,2,0
12/25/2017 12:00,37,72.7,53,68.2,90,70,2,0
12/25/2017 12:05,33,71.7,49,67.2,82,69,2,0
12/25/2017 12:10,35,72,51,67.6,86,69.4,2,0
12/25/2017 12:15,37,71.7,53,67.2,90,69,2,0
12/25/2017 12:20,57,72.6,74,68.2,131,70.1,2,0
12/25/2017 12:25,39,72.3,56,67.9,95,69.7,2,0
12/25/2017 12:30,35,72.3,53,67.9,88,69.7,2,0
12/25/2017 12:35,40,72,57,67.6,97,69.4,2,0
12/25/2017 12:40,33,71.4,49,66.9,82,68.7,2,0
12/25/2017 12:45,40,71.6,57,67.1,97,69,2,0
12/25/2017 12:50,33,71.5,49,67.1,82,68.9,2,0
12/25/2017 12:55,39,71.7,56,67.3,95,69.1,2,0
12/25/2017 13:00,33,72,49,67.6,82,69.3,2,0
12/25/2017 13:05,37,72.2,53,67.7,90,69.5,2,0
12/25/2017 13:10,36,71.8,52,67.3,88,69.1,2,0
12/25/2017 13:15,33,71.4,49,67,82,68.8,2,0
12/25/2017 13:20,37,71.7,53,67.3,90,69.1,2,0
12/25/2017 13:25,37,71.6,54,67.1,91,69,2,0
12/25/2017 13:30,41,71.5,59,67.1,100,68.9,2,0
12/25/2017 13:35,38,71.5,55,67.1,93,68.9,2,0
12/25/2017 13:40,37,71.8,54,67.4,91,69.2,2,0
12/25/2017 13:45,40,71.9,57,67.5,97,69.3,2,0
12/25/2017 13:50,40,71.8,58,67.4,98,69.2,2,0
12/25/2017 13:55,37,71.8,54,67.4,91,69.2,2,0
12/25/2017 14:00,37,72.2,54,67.8,91,69.6,2,0
12/25/2017 14:05,41,72.1,58,67.7,99,69.6,2,0
12/25/2017 14:10,37,72.1,54,67.7,91,69.5,2,0
12/25/2017 14:15,33,71.9,49,67.4,82,69.2,2,0
12/25/2017 14:20,31,71.6,48,67.1,79,68.9,2,0
12/25/2017 14:25,36,71.3,53,66.8,89,68.6,2,0
12/25/2017 14:30,33,71.7,49,67.3,82,69.1,2,0
12/25/2017 14:35,38,71.7,55,67.2,93,69,2,0
12/25/2017 14:40,41,71.6,58,67,99,68.9,2,0
12/25/2017 14:45,41,71.1,59,66.6,100,68.5,2,0
12/25/2017 14:50,33,71.5,49,67.1,82,68.9,2,0
12/25/2017 14:55,38,71.5,55,67.1,93,68.9,2,0
12/25/2017 15:00,46,72,64,67.5,110,69.4,2,0
12/25/2017 15:05,44,72.1,62,67.7,106,69.5,2,0
12/25/2017 15:10,36,71.1,53,66.6,89,68.4,2,0
12/25/2017 15:15,39,70.8,56,66.3,95,68.2,2,0
12/25/2017 15:20,50,71.4,67,67,117,68.9,2,0
12/25/2017 15:25,33,71.2,50,66.8,83,68.5,2,0
12/25/2017 15:30,36,71.2,53,66.8,89,68.6,2,0
12/25/2017 15:35,44,71.9,61,67.4,105,69.3,2,0
12/25/2017 15:40,43,71.5,61,67.1,104,68.9,2,0
12/25/2017 15:45,38,71.5,55,67.1,93,68.9,2,0
12/25/2017 15:50,43,71.7,59,67.3,102,69.1,2,0
12/25/2017 15:55,41,71.6,58,67.1,99,69,2,0
12/25/2017 16:00,38,71.8,54,67.4,92,69.2,2,0
12/25/2017 16:05,31,71.3,48,66.9,79,68.6,2,0
12/25/2017 16:10,38,71.5,55,67.1,93,68.9,2,0
12/25/2017 16:15,41,71.5,58,67,99,68.9,2,0
12/25/2017 16:20,44,71.5,62,67.1,106,69,2,0
12/25/2017 16:25,42,71.7,60,67.3,102,69.1,2,0
12/25/2017 16:30,42,71.8,59,67.4,101,69.2,2,0
12/25/2017 16:35,38,71.9,54,67.5,92,69.3,2,0
12/25/2017 16:40,34,71.6,50,67.1,84,68.9,2,0
12/25/2017 16:45,39,71.4,56,66.9,95,68.7,2,0
12/25/2017 16:50,36,71.1,52,66.6,88,68.4,2,0
12/25/2017 16:55,36,71,53,66.4,89,68.3,2,0
12/25/2017 17:00,34,71.1,50,66.6,84,68.4,2,0
12/25/2017 17:05,33,71.1,49,66.6,82,68.4,2,0
12/25/2017 17:10,41,71.1,57,66.6,98,68.5,2,0
12/25/2017 17:15,35,71.4,51,66.9,86,68.8,2,0
12/25/2017 17:20,33,71.2,50,66.7,83,68.5,2,0
12/25/2017 17:25,41,70.7,58,66.2,99,68,2,0
12/25/2017 17:30,44,70.8,61,66.3,105,68.1,2,0
12/25/2017 17:35,42,70.5,58,65.9,100,67.8,2,0
12/25/2017 17:40,40,70.8,57,66.2,97,68.1,2,0
12/25/2017 17:45,32,70.7,48,66.2,80,68,2,0
12/25/2017 17:50,32,71.3,49,66.8,81,68.6,2,0
12/25/2017 17:55,26,70.5,43,66,69,67.7,2,0
12/25/2017 18:00,28,70,44,65.5,72,67.3,2,0
12/25/2017 18:05,25,69.7,40,65.1,65,66.9,2,0
12/25/2017 18:10,36,70.1,53,65.6,89,67.4,2,0
12/25/2017 18:15,29,69.3,46,64.7,75,66.5,2,0
12/25/2017 18:20,28,69.3,44,64.7,72,66.5,2,0
12/25/2017 18:25,29,69.7,45,65.1,74,66.9,2,0
12/25/2017 18:30,32,69.9,48,65.3,80,67.2,2,0
12/25/2017 18:35,35,70,51,65.5,86,67.3,2,0
12/25/2017 18:40,34,70.4,51,65.8,85,67.7,2,0
12/25/2017 18:45,37,70.4,53,65.9,90,67.7,2,0
12/25/2017 18:50,35,70.7,51,66.2,86,68.1,2,0
12/25/2017 18:55,35,70.2,51,65.6,86,67.5,2,0
12/25/2017 19:00,31,70,47,65.4,78,67.2,2,0
12/25/2017 19:05,28,69.9,44,65.3,72,67.1,2,0
12/25/2017 19:10,37,69.8,54,65.3,91,67.1,2,0
12/25/2017 19:15,35,69.5,51,64.9,86,66.8,2,0
12/25/2017 19:20,25,69.5,41,64.9,66,66.6,2,0
12/25/2017 19:25,25,69.6,41,65,66,66.8,2,0
12/25/2017 19:30,30,69.7,46,65.1,76,66.9,2,0
12/25/2017 19:35,35,69.3,51,64.8,86,66.6,2,0
12/25/2017 19:40,34,69.6,50,65.1,84,66.9,2,0
12/25/2017 19:45,32,69.7,48,65.1,80,66.9,2,0
12/25/2017 19:50,32,69.6,49,65,81,66.8,2,0
12/25/2017 19:55,26,69.8,42,65.2,68,66.9,2,0
12/25/2017 20:00,27,69.4,43,64.7,70,66.5,2,0
12/25/2017 20:05,30,69,46,64.3,76,66.2,2,0
12/25/2017 20:10,31,69.3,47,64.6,78,66.5,2,0
12/25/2017 20:15,38,69.3,53,64.7,91,66.6,2,0
12/25/2017 20:20,30,69.4,46,64.8,76,66.6,2,0
12/25/2017 20:25,33,68.9,50,64.2,83,66.1,2,0
12/25/2017 20:30,35,69.5,52,64.9,87,66.7,2,0
12/25/2017 20:35,33,69.4,50,64.8,83,66.7,2,0
12/25/2017 20:40,29,69.3,46,64.7,75,66.5,2,0
12/25/2017 20:45,31,69.4,47,64.7,78,66.6,2,0
12/25/2017 20:50,32,69.1,49,64.4,81,66.2,2,0
12/25/2017 20:55,30,68.7,46,64,76,65.8,2,0
12/25/2017 21:00,35,69.2,51,64.6,86,66.4,2,0
12/25/2017 21:05,34,69.4,51,64.8,85,66.6,2,0
12/25/2017 21:10,37,69.8,54,65.2,91,67,2,0
12/25/2017 21:15,37,69.8,54,65.2,91,67,2,0
12/25/2017 21:20,33,68.8,49,64.2,82,66,2,0
12/25/2017 21:25,31,69.3,47,64.7,78,66.5,2,0
12/25/2017 21:30,33,69.3,49,64.7,82,66.6,2,0
12/25/2017 21:35,29,69.6,46,65,75,66.8,2,0
12/25/2017 21:40,36,68.8,53,64.1,89,66,2,0
12/25/2017 21:45,32,69,48,64.3,80,66.2,2,0
12/25/2017 21:50,34,69.2,51,64.5,85,66.4,2,0
12/25/2017 21:55,31,69.3,48,64.7,79,66.5,2,0
12/25/2017 22:00,26,69.1,42,64.4,68,66.2,2,0
12/25/2017 22:05,26,69.4,43,64.8,69,66.5,2,0
12/25/2017 22:10,30,69.7,47,65.2,77,66.9,2,0
12/25/2017 22:15,27,68.8,43,64.1,70,65.9,2,0
12/25/2017 22:20,29,69.3,45,64.7,74,66.5,2,0
12/25/2017 22:25,22,69.4,38,64.7,60,66.4,2,0
12/25/2017 22:30,20,69.3,36,64.7,56,66.3,2,0
12/25/2017 22:35,27,69.6,44,65.1,71,66.8,2,0
12/25/2017 22:40,22,69.8,39,65.2,61,66.8,2,0
12/25/2017 22:45,15,69.5,31,65,46,66.5,2,0
12/25/2017 22:50,23,69.8,38,65.2,61,66.9,2,0
12/25/2017 22:55,19,69.6,34,65,53,66.6,2,0
12/25/2017 23:00,15,69.4,31,64.8,46,66.3,2,0
12/25/2017 23:05,16,69.5,32,64.9,48,66.5,2,0
12/25/2017 23:10,13,69.5,28,64.9,41,66.3,2,0
12/25/2017 23:15,14,69.5,30,64.9,44,66.3,2,0
12/25/2017 23:20,14,69.5,29,64.9,43,66.4,2,0
12/25/2017 23:25,12,69.5,28,64.9,40,66.3,2,0
12/25/2017 23:30,17,69.5,32,64.9,49,66.5,2,0
12/25/2017 23:35,17,69.5,33,64.9,50,66.4,2,0
12/25/2017 23:40,17,69.8,32,65.2,49,66.8,2,0
12/25/2017 23:45,14,69.3,30,64.7,44,66.2,2,0
12/25/2017 23:50,12,69.5,27,64.9,39,66.3,2,0
12/25/2017 23:55,12,69.5,27,64.9,39,66.3,2,0
12/26/2017 0:00,10,69.3,25,64.7,35,66.1,2,0
12/26/2017 0:05,11,69.3,27,64.7,38,66,2,0
12/26/2017 0:10,11,69.4,26,64.8,37,66.1,2,0
12/26/2017 0:15,13,69.1,29,64.5,42,65.9,2,0
12/26/2017 0:20,11,69.3,27,64.7,38,66.1,2,0
12/26/2017 0:25,9,69.4,24,64.8,33,66,2,0
12/26/2017 0:30,8,69.4,24,64.8,32,65.9,2,0
12/26/2017 0:35,7,69.2,22,64.6,29,65.7,2,0
12/26/2017 0:40,7,69.3,22,64.7,29,65.8,2,0
12/26/2017 0:45,8,69.3,23,64.7,31,65.9,2,0
12/26/2017 0:50,7,69.3,22,64.7,29,65.8,2,0
12/26/2017 0:55,10,69.4,25,64.8,35,66.2,2,0
12/26/2017 1:00,6,69.3,22,64.7,28,65.7,2,0
12/26/2017 1:05,9,69.3,24,64.7,33,66,2,0
12/26/2017 1:10,8,69.4,23,64.8,31,66,2,0
12/26/2017 1:15,6,69.4,21,64.8,27,65.8,2,0
12/26/2017 1:20,6,69.4,21,64.8,27,65.8,2,0
12/26/2017 1:25,9,69.4,19,64.8,28,66.3,2,0
12/26/2017 1:30,8,69.2,23,64.6,31,65.8,2,0
12/26/2017 1:35,5,69,21,64.3,26,65.2,2,0
12/26/2017 1:40,8,69.1,23,64.4,31,65.6,2,0
12/26/2017 1:45,6,69.2,22,64.6,28,65.6,2,0
12/26/2017 1:50,6,69.3,21,64.7,27,65.7,2,0
12/26/2017 1:55,6,69.3,21,64.7,27,65.7,2,0
12/26/2017 2:00,6,69.4,21,64.8,27,65.8,2,0
12/26/2017 2:05,9,69.4,19,64.8,28,66.3,2,0
12/26/2017 2:10,11,69.4,21,64.8,32,66.4,2,0
12/26/2017 2:15,6,69.4,21,64.8,27,65.8,2,0
12/26/2017 2:20,5,69.4,20,64.8,25,65.7,2,0
12/26/2017 2:25,12,69.4,21,64.8,33,66.5,2,0
12/26/2017 2:30,6,69.3,22,64.7,28,65.7,2,0
12/26/2017 2:35,7,69.3,23,64.7,30,65.8,2,0
12/26/2017 2:40,8,69.4,23,64.8,31,66,2,0
12/26/2017 2:45,7,69.4,22,64.8,29,66,2,0
12/26/2017 2:50,9,69.4,24,64.8,33,66.1,2,0
12/26/2017 2:55,9,69.3,24,64.7,33,65.9,2,0
12/26/2017 3:00,8,69.3,24,64.7,32,65.8,2,0
12/26/2017 3:05,13,68.4,29,63.7,42,65.2,2,0
12/26/2017 3:10,8,68.8,24,64.2,32,65.3,2,0
12/26/2017 3:15,9,69.1,24,64.4,33,65.7,2,0
12/26/2017 3:20,7,69.2,23,64.6,30,65.7,2,0
12/26/2017 3:25,8,69.1,24,64.4,32,65.6,2,0
12/26/2017 3:30,11,69.2,27,64.6,38,66,2,0
12/26/2017 3:35,14,69.4,30,64.8,44,66.3,2,0
12/26/2017 3:40,13,69.4,29,64.8,42,66.3,2,0
12/26/2017 3:45,11,69.4,27,64.8,38,66.2,2,0
12/26/2017 3:50,17,69.1,33,64.5,50,66,2,0
12/26/2017 3:55,11,69.3,27,64.7,38,66,2,0
12/26/2017 4:00,13,69.3,29,64.7,42,66.2,2,0
12/26/2017 4:05,14,69.2,31,64.6,45,66,2,0
12/26/2017 4:10,19,69.3,35,64.7,54,66.3,2,0
12/26/2017 4:15,21,68.6,36,64,57,65.7,2,0
12/26/2017 4:20,20,68.8,36,64.2,56,65.9,2,0
12/26/2017 4:25,20,68.2,36,63.6,56,65.2,2,0
12/26/2017 4:30,25,69,41,64.4,66,66.1,2,0
12/26/2017 4:35,20,69.1,36,64.5,56,66.2,2,0
12/26/2017 4:40,25,69.8,41,65.2,66,66.9,2,0
12/26/2017 4:45,31,70.1,48,65.6,79,67.4,2,0
12/26/2017 4:50,26,69.7,43,65.1,69,66.8,2,0
12/26/2017 4:55,28,69.7,45,65.1,73,66.8,2,0
12/26/2017 5:00,33,70.1,51,65.6,84,67.4,2,0
12/26/2017 5:05,29,70.2,46,65.7,75,67.5,2,0
12/26/2017 5:10,31,70.3,47,65.8,78,67.6,2,0
12/26/2017 5:15,30,69.6,47,65.1,77,66.8,2,0
12/26/2017 5:20,36,69.5,55,64.9,91,66.7,2,0
12/26/2017 5:25,32,69.7,50,65.1,82,66.9,2,0
12/26/2017 5:30,41,69.9,59,65.3,100,67.2,2,0
12/26/2017 5:35,35,70.4,53,65.9,88,67.7,2,0
12/26/2017 5:40,36,69.6,55,65,91,66.8,2,0
12/26/2017 5:45,40,69.2,58,64.5,98,66.4,2,0
12/26/2017 5:50,47,68.5,67,63.9,114,65.8,2,0
12/26/2017 5:55,35,69,53,64.4,88,66.2,2,0
12/26/2017 6:00,42,69.4,60,64.7,102,66.6,2,0
12/26/2017 6:05,41,68.7,59,64,100,66,2,0
12/26/2017 6:10,38,68.2,56,63.5,94,65.4,2,0
12/26/2017 6:15,40,68.8,58,64.1,98,66,2,0
12/26/2017 6:20,36,68.5,54,63.9,90,65.7,2,0
12/26/2017 6:25,42,68.3,61,63.6,103,65.5,2,0
12/26/2017 6:30,40,68.4,59,63.7,99,65.6,2,0
12/26/2017 6:35,44,68.7,63,64,107,66,2,0
12/26/2017 6:40,45,69.1,63,64.4,108,66.4,2,0
12/26/2017 6:45,43,69.7,61,65.1,104,67,2,0
12/26/2017 6:50,44,69.8,63,65.2,107,67.1,2,0
12/26/2017 6:55,45,69.7,64,65,109,66.9,2,0
12/26/2017 7:00,37,68.6,55,63.8,92,65.7,2,0
12/26/2017 7:05,44,67.4,62,62.6,106,64.6,2,0
12/26/2017 7:10,43,67.8,62,63,105,64.9,2,0
12/26/2017 7:15,42,68.1,59,63.3,101,65.3,2,0
12/26/2017 7:20,46,69.5,63,64.9,109,66.8,2,0
12/26/2017 7:25,48,70.5,67,66,115,67.8,2,0
12/26/2017 7:30,39,69.1,57,64.3,96,66.3,2,0
12/26/2017 7:35,45,68.5,63,63.8,108,65.8,2,0
12/26/2017 7:40,43,68.8,62,64.1,105,66,2,0
12/26/2017 7:45,47,68.7,65,64,112,66,2,0
12/26/2017 7:50,40,69,58,64.4,98,66.3,2,0
12/26/2017 7:55,46,69.2,64,64.6,110,66.5,2,0
12/26/2017 8:00,42,69.4,59,64.8,101,66.8,2,0
12/26/2017 8:05,48,68.7,66,64,114,66,2,0
12/26/2017 8:10,43,68.6,60,64,103,65.9,2,0
12/26/2017 8:15,43,69,60,64.4,103,66.3,2,0
12/26/2017 8:20,47,69,65,64.4,112,66.3,2,0
12/26/2017 8:25,41,69.7,57,65.1,98,67,2,0
12/26/2017 8:30,37,69.7,54,65.2,91,67,2,0
12/26/2017 8:35,40,69.9,58,65.3,98,67.2,2,0
12/26/2017 8:40,48,69.2,67,64.6,115,66.5,2,0
12/26/2017 8:45,50,69.6,68,65.1,118,67,2,0
12/26/2017 8:50,37,69.8,54,65.3,91,67.1,2,0
12/26/2017 8:55,44,69.5,62,64.9,106,66.8,2,0
12/26/2017 9:00,36,68,53,63.3,89,65.2,2,0
12/26/2017 9:05,34,67.4,52,62.6,86,64.5,2,0
12/26/2017 9:10,41,67.3,59,62.6,100,64.5,2,0
12/26/2017 9:15,45,67.5,63,62.8,108,64.8,2,0
12/26/2017 9:20,47,68.2,63,63.5,110,65.5,2,0
12/26/2017 9:25,41,68.3,57,63.7,98,65.6,2,0
12/26/2017 9:30,42,68.7,60,64,102,65.9,2,0
12/26/2017 9:35,43,68.1,60,63.4,103,65.4,2,0
12/26/2017 9:40,50,69.5,67,64.9,117,66.9,2,0
12/26/2017 9:45,47,70.6,65,66.2,112,68,2,0
12/26/2017 9:50,57,67.6,75,63,132,65,2,0
12/26/2017 9:55,56,68.1,74,63.4,130,65.4,2,0
12/26/2017 10:00,50,68.9,67,64.3,117,66.2,2,0
12/26/2017 10:05,52,68.9,70,64.3,122,66.3,2,0
12/26/2017 10:10,45,68.3,62,63.7,107,65.6,2,0
12/26/2017 10:15,49,68.1,66,63.4,115,65.4,2,0
12/26/2017 10:20,53,68.2,71,63.6,124,65.6,2,0
12/26/2017 10:25,53,67.9,71,63.2,124,65.2,2,0
12/26/2017 10:30,48,67.7,65,63,113,65,2,0
12/26/2017 10:35,56,68.1,74,63.3,130,65.4,2,0
12/26/2017 10:40,48,68.3,66,63.6,114,65.6,2,0
12/26/2017 10:45,50,68.5,68,63.8,118,65.8,2,0
12/26/2017 10:50,49,68.7,68,64.1,117,66.1,2,0
12/26/2017 10:55,39,69.3,56,64.8,95,66.7,2,0
12/26/2017 11:00,42,69.3,59,64.7,101,66.6,2,0
12/26/2017 11:05,44,69.3,62,64.7,106,66.6,2,0
12/26/2017 11:10,42,68.5,61,63.9,103,65.8,2,0
12/26/2017 11:15,54,68.8,71,64.2,125,66.2,2,0
12/26/2017 11:20,54,68.2,73,63.6,127,65.5,2,0
12/26/2017 11:25,55,68.9,74,64.2,129,66.2,2,0
12/26/2017 11:30,46,68.7,64,64.1,110,66,2,0
12/26/2017 11:35,47,69,64,64.4,111,66.3,2,0
12/26/2017 11:40,60,67.9,79,63.1,139,65.2,2,0
12/26/2017 11:45,55,68.2,73,63.6,128,65.6,2,0
12/26/2017 11:50,49,67.9,67,63.2,116,65.2,2,0
12/26/2017 11:55,58,68.1,76,63.5,134,65.5,2,0
12/26/2017 12:00,57,68.2,76,63.5,133,65.5,2,0
12/26/2017 12:05,48,68.3,66,63.6,114,65.5,2,0
12/26/2017 12:10,58,69.7,77,65.1,135,67.1,2,0
12/26/2017 12:15,47,70.5,64,66,111,67.9,2,0
12/26/2017 12:20,47,70.9,65,66.4,112,68.3,2,0
12/26/2017 12:25,47,71.2,63,66.7,110,68.6,2,0
12/26/2017 12:30,46,70.3,64,65.8,110,67.7,2,0
12/26/2017 12:35,46,69.1,65,64.4,111,66.3,2,0
12/26/2017 12:40,50,69.3,68,64.6,118,66.6,2,0
12/26/2017 12:45,45,68.9,63,64.1,108,66.1,2,0
12/26/2017 12:50,53,69.2,70,64.5,123,66.6,2,0
12/26/2017 12:55,39,69.7,58,65.1,97,66.9,2,0
12/26/2017 13:00,48,69.7,66,65,114,67,2,0
12/26/2017 13:05,46,70.2,64,65.7,110,67.6,2,0
12/26/2017 13:10,51,69.8,70,65.2,121,67.1,2,0
12/26/2017 13:15,49,69.8,66,65.2,115,67.1,2,0
12/26/2017 13:20,47,70.8,64,66.3,111,68.2,2,0
12/26/2017 13:25,45,71.6,62,67.2,107,69,2,0
12/26/2017 13:30,52,71.6,69,67.2,121,69.1,2,0
12/26/2017 13:35,45,71.1,62,66.7,107,68.5,2,0
12/26/2017 13:40,50,70.5,68,66.1,118,68,2,0
12/26/2017 13:45,52,71,70,66.6,122,68.5,2,0
12/26/2017 13:50,51,70.7,68,66.2,119,68.1,2,0
12/26/2017 13:55,49,71.8,67,67.4,116,69.3,2,0
12/26/2017 14:00,51,71.3,69,66.8,120,68.7,2,0
12/26/2017 14:05,51,71,68,66.5,119,68.5,2,0
12/26/2017 14:10,51,68.9,67,64.1,118,66.2,2,0
12/26/2017 14:15,52,69.8,70,65.2,122,67.2,2,0
12/26/2017 14:20,52,70.6,69,66.1,121,68,2,0
12/26/2017 14:25,64,70.7,83,66.2,147,68.2,2,0
12/26/2017 14:30,54,70.1,73,65.5,127,67.5,2,0
12/26/2017 14:35,60,69.8,79,65.2,139,67.2,2,0
12/26/2017 14:40,52,70.6,69,66.1,121,68,2,0
12/26/2017 14:45,51,70.8,69,66.2,120,68.1,2,0
12/26/2017 14:50,50,70,68,65.4,118,67.3,2,0
12/26/2017 14:55,52,69.6,69,65,121,67,2,0
12/26/2017 15:00,48,68.7,65,64,113,66,2,0
12/26/2017 15:05,43,69,61,64.3,104,66.3,2,0
12/26/2017 15:10,52,69.6,70,65,122,67,2,0
12/26/2017 15:15,43,70,60,65.4,103,67.3,2,0
12/26/2017 15:20,48,69.4,66,64.8,114,66.8,2,0
12/26/2017 15:25,48,70,64,65.5,112,67.4,2,0
12/26/2017 15:30,49,67.7,68,62.9,117,64.9,2,0
12/26/2017 15:35,55,68.5,74,63.8,129,65.8,2,0
12/26/2017 15:40,56,68.7,74,64,130,66,2,0
12/26/2017 15:45,55,68.8,74,64.2,129,66.1,2,0
12/26/2017 15:50,58,70,76,65.6,134,67.5,2,0
12/26/2017 15:55,52,70.6,69,66.1,121,68,2,0
12/26/2017 16:00,49,70.8,66,66.4,115,68.3,2,0
12/26/2017 16:05,43,71.3,60,66.9,103,68.8,2,0
12/26/2017 16:10,52,70.6,70,66.1,122,68,2,0
12/26/2017 16:15,51,70.5,69,66.1,120,68,2,0
12/26/2017 16:20,49,71.1,66,66.7,115,68.6,2,0
12/26/2017 16:25,38,72,55,67.6,93,69.4,2,0
12/26/2017 16:30,59,71.4,77,67,136,68.9,2,0
12/26/2017 16:35,49,70.9,67,66.4,116,68.3,2,0
12/26/2017 16:40,46,71,64,66.6,110,68.4,2,0
12/26/2017 16:45,43,70.1,61,65.6,104,67.4,2,0
12/26/2017 16:50,55,70.1,73,65.6,128,67.5,2,0
12/26/2017 16:55,47,70,65,65.5,112,67.4,2,0
12/26/2017 17:00,41,70.3,58,65.9,99,67.7,2,0
12/26/2017 17:05,39,70.4,56,65.9,95,67.7,2,0
12/26/2017 17:10,47,70.2,65,65.6,112,67.5,2,0
12/26/2017 17:15,50,70.7,68,66.2,118,68.1,2,0
12/26/2017 17:20,51,70.5,69,66,120,67.9,2,0
12/26/2017 17:25,51,71,68,66.6,119,68.5,2,0
12/26/2017 17:30,43,69.5,60,65,103,66.9,2,0
12/26/2017 17:35,47,70.3,64,65.9,111,67.7,2,0
12/26/2017 17:40,50,69.9,67,65.4,117,67.3,2,0
12/26/2017 17:45,44,70.3,60,65.8,104,67.7,2,0
12/26/2017 17:50,49,70,67,65.5,116,67.4,2,0
12/26/2017 17:55,50,70.4,68,65.9,118,67.8,2,0
12/26/2017 18:00,45,71.1,62,66.6,107,68.5,2,0
12/26/2017 18:05,48,70.3,65,65.8,113,67.7,2,0
12/26/2017 18:10,44,69.7,63,65.2,107,67,2,0
12/26/2017 18:15,46,70,64,65.5,110,67.4,2,0
12/26/2017 18:20,38,70.4,54,65.9,92,67.7,2,0
12/26/2017 18:25,37,70,54,65.4,91,67.3,2,0
12/26/2017 18:30,45,69.7,62,65.2,107,67.1,2,0
12/26/2017 18:35,40,69.7,57,65.2,97,67.1,2,0
12/26/2017 18:40,35,69,52,64.4,87,66.2,2,0
12/26/2017 18:45,41,68.6,59,64,100,65.8,2,0
12/26/2017 18:50,40,69.6,56,65.1,96,67,2,0
12/26/2017 18:55,39,70.6,56,66.1,95,67.9,2,0
12/26/2017 19:00,33,70.2,50,65.7,83,67.5,2,0
12/26/2017 19:05,38,69.5,56,64.8,94,66.7,2,0
12/26/2017 19:10,32,69.7,48,65,80,66.9,2,0
12/26/2017 19:15,38,69.7,54,65.1,92,67,2,0
12/26/2017 19:20,36,69.2,53,64.5,89,66.4,2,0
12/26/2017 19:25,33,69.6,50,65,83,66.8,2,0
12/26/2017 19:30,34,69.6,51,64.9,85,66.8,2,0
12/26/2017 19:35,32,69.8,48,65.2,80,67.1,2,0
12/26/2017 19:40,34,70.2,50,65.7,84,67.5,2,0
12/26/2017 19:45,35,70.4,51,65.9,86,67.8,2,0
12/26/2017 19:50,28,70.4,45,65.8,73,67.6,2,0
12/26/2017 19:55,30,70.4,46,65.8,76,67.6,2,0
12/26/2017 20:00,30,69.1,46,64.5,76,66.3,2,0
12/26/2017 20:05,25,68.6,41,64,66,65.8,2,0
12/26/2017 20:10,33,68.7,49,64.1,82,66,2,0
12/26/2017 20:15,33,69.3,50,64.7,83,66.6,2,0
12/26/2017 20:20,35,69.5,51,64.9,86,66.7,2,0
12/26/2017 20:25,25,69.2,41,64.6,66,66.4,2,0
12/26/2017 20:30,31,69.5,47,64.9,78,66.7,2,0
12/26/2017 20:35,23,69.1,39,64.5,62,66.2,2,0
12/26/2017 20:40,38,68.9,54,64.2,92,66.2,2,0
12/26/2017 20:45,25,69.3,42,64.7,67,66.4,2,0
12/26/2017 20:50,25,69.4,41,64.8,66,66.6,2,0
12/26/2017 20:55,27,69.6,43,65,70,66.7,2,0
12/26/2017 21:00,26,69,43,64.4,69,66.1,2,0
12/26/2017 21:05,26,68.8,42,64.2,68,65.9,2,0
12/26/2017 21:10,32,69.4,49,64.8,81,66.6,2,0
12/26/2017 21:15,23,69.5,39,64.9,62,66.6,2,0
12/26/2017 21:20,28,69.4,45,64.8,73,66.5,2,0
12/26/2017 21:25,21,68.2,37,63.5,58,65.2,2,0
12/26/2017 21:30,27,68.6,44,63.9,71,65.7,2,0
12/26/2017 21:35,25,69.2,42,64.6,67,66.3,2,0
12/26/2017 21:40,18,69,34,64.4,52,66,2,0
12/26/2017 21:45,18,69.4,34,64.8,52,66.4,2,0
12/26/2017 21:50,17,69.5,33,64.9,50,66.5,2,0
12/26/2017 21:55,22,69.2,38,64.5,60,66.2,2,0
12/26/2017 22:00,20,69.3,35,64.6,55,66.3,2,0
12/26/2017 22:05,17,69.3,32,64.7,49,66.3,2,0
12/26/2017 22:10,19,69.4,35,64.8,54,66.4,2,0
12/26/2017 22:15,16,69.5,32,64.9,48,66.4,2,0
12/26/2017 22:20,19,69.4,35,64.8,54,66.4,2,0
12/26/2017 22:25,19,69.5,35,64.9,54,66.5,2,0
12/26/2017 22:30,18,69.5,34,64.9,52,66.5,2,0
12/26/2017 22:35,21,69.6,37,65,58,66.7,2,0
12/26/2017 22:40,17,69.4,34,64.8,51,66.3,2,0
12/26/2017 22:45,17,69.4,34,64.8,51,66.3,2,0
12/26/2017 22:50,16,69.6,32,65,48,66.5,2,0
12/26/2017 22:55,16,69.6,32,65,48,66.5,2,0
12/26/2017 23:00,13,69.5,28,64.9,41,66.3,2,0
12/26/2017 23:05,16,69.4,31,64.8,47,66.4,2,0
12/26/2017 23:10,18,69.5,33,64.9,51,66.6,2,0
12/26/2017 23:15,16,69.5,31,64.9,47,66.4,2,0
12/26/2017 23:20,17,69.6,32,65,49,66.6,2,0
12/26/2017 23:25,12,69.6,27,65,39,66.4,2,0
12/26/2017 23:30,15,69.5,30,64.9,45,66.4,2,0
12/26/2017 23:35,16,68.7,31,64.1,47,65.7,2,0
12/26/2017 23:40,15,68.7,30,64,45,65.6,2,0
12/26/2017 23:45,13,68.9,28,64.2,41,65.7,2,0
12/26/2017 23:50,16,69.1,31,64.5,47,66.1,2,0
12/26/2017 23:55,10,69.2,26,64.6,36,65.9,2,0
12/27/2017 0:00,10,69.3,25,64.7,35,66.1,2,0
12/27/2017 0:05,9,69.2,24,64.5,33,65.8,2,0
12/27/2017 0:10,10,69.4,26,64.8,36,66,2,0
12/27/2017 0:15,11,69.5,26,64.9,37,66.3,2,0
12/27/2017 0:20,13,69.4,28,64.7,41,66.2,2,0
12/27/2017 0:25,10,69.4,25,64.8,35,66.1,2,0
12/27/2017 0:30,14,69,30,64.4,44,65.8,2,0
12/27/2017 0:35,11,69.2,26,64.6,37,66,2,0
12/27/2017 0:40,10,69.4,25,64.8,35,66.1,2,0
12/27/2017 0:45,10,69.4,26,64.8,36,66.1,2,0
12/27/2017 0:50,11,69.4,26,64.8,37,66.2,2,0
12/27/2017 0:55,11,69.4,21,64.8,32,66.4,2,0
12/27/2017 1:00,10,69.4,25,64.7,35,66.1,2,0
12/27/2017 1:05,10,69.3,25,64.7,35,66.1,2,0
12/27/2017 1:10,7,69.3,22,64.7,29,65.8,2,0
12/27/2017 1:15,8,69.3,23,64.7,31,65.9,2,0
12/27/2017 1:20,8,69.3,24,64.7,32,65.8,2,0
12/27/2017 1:25,7,69.4,22,64.8,29,65.9,2,0
12/27/2017 1:30,8,69.4,23,64.8,31,66,2,0
12/27/2017 1:35,6,69.4,22,64.8,28,65.8,2,0
12/27/2017 1:40,12,69.4,21,64.8,33,66.5,2,0
12/27/2017 1:45,9,69.4,24,64.8,33,66.1,2,0
12/27/2017 1:50,7,69.5,22,64.9,29,66,2,0
12/27/2017 1:55,7,69.4,22,64.8,29,65.9,2,0
12/27/2017 2:00,5,69.4,20,64.8,25,65.7,2,0
12/27/2017 2:05,9,69.4,19,64.8,28,66.3,2,0
12/27/2017 2:10,6,69.4,21,64.7,27,65.8,2,0
12/27/2017 2:15,16,69.2,23,64.6,39,66.5,2,0
12/27/2017 2:20,9,69.3,19,64.7,28,66.1,2,0
12/27/2017 2:25,6,69.3,21,64.7,27,65.8,2,0
12/27/2017 2:30,9,69.3,24,64.7,33,66,2,0
12/27/2017 2:35,8,69.3,23,64.6,31,65.8,2,0
12/27/2017 2:40,12,69.5,27,64.9,39,66.3,2,0
12/27/2017 2:45,18,69.3,24,64.7,42,66.6,2,0
12/27/2017 2:50,9,68.8,24,64.2,33,65.5,2,0
12/27/2017 2:55,9,69,24,64.3,33,65.6,2,0
12/27/2017 3:00,7,69.2,23,64.6,30,65.7,2,0
12/27/2017 3:05,9,69,25,64.4,34,65.7,2,0
12/27/2017 3:10,11,69,26,64.4,37,65.8,2,0
12/27/2017 3:15,10,69.3,26,64.7,36,66,2,0
12/27/2017 3:20,7,69.4,22,64.8,29,66,2,0
12/27/2017 3:25,10,69.3,26,64.7,36,66,2,0
12/27/2017 3:30,12,69.4,28,64.8,40,66.2,2,0
12/27/2017 3:35,14,69.5,30,64.9,44,66.4,2,0
12/27/2017 3:40,14,69.5,30,64.9,44,66.4,2,0
12/27/2017 3:45,15,69.6,31,65,46,66.5,2,0
12/27/2017 3:50,17,69.6,33,65,50,66.6,2,0
12/27/2017 3:55,15,69.5,31,64.9,46,66.4,2,0
12/27/2017 4:00,13,68.7,29,64,42,65.5,2,0
12/27/2017 4:05,20,69.1,37,64.5,57,66.1,2,0
12/27/2017 4:10,18,68.6,35,64,53,65.6,2,0
12/27/2017 4:15,18,69,35,64.4,53,66,2,0
12/27/2017 4:20,29,69.3,46,64.7,75,66.5,2,0
12/27/2017 4:25,24,68.8,39,64.1,63,65.9,2,0
12/27/2017 4:30,22,69.1,39,64.5,61,66.2,2,0
12/27/2017 4:35,29,69.6,46,65,75,66.8,2,0
12/27/2017 4:40,36,68.4,53,63.8,89,65.7,2,0
12/27/2017 4:45,36,69.2,54,64.6,90,66.4,2,0
12/27/2017 4:50,32,69.3,50,64.7,82,66.5,2,0
12/27/2017 4:55,35,69.8,52,65.3,87,67.1,2,0
12/27/2017 5:00,36,70.4,53,65.9,89,67.7,2,0
12/27/2017 5:05,42,70.1,61,65.6,103,67.4,2,0
12/27/2017 5:10,30,69.8,49,65.2,79,66.9,2,0
12/27/2017 5:15,40,70.3,58,65.8,98,67.7,2,0
12/27/2017 5:20,47,69.5,66,64.9,113,66.8,2,0
12/27/2017 5:25,42,69.3,60,64.7,102,66.6,2,0
12/27/2017 5:30,47,68.2,66,63.4,113,65.4,2,0
12/27/2017 5:35,44,69.1,63,64.5,107,66.4,2,0
12/27/2017 5:40,52,70.1,71,65.6,123,67.5,2,0
12/27/2017 5:45,53,69.6,72,65.1,125,67,2,0
12/27/2017 5:50,53,70.5,72,66,125,67.9,2,0
12/27/2017 5:55,52,70,72,65.4,124,67.3,2,0
12/27/2017 6:00,52,69,72,64.4,124,66.3,2,0
12/27/2017 6:05,37,69.1,55,64.4,92,66.3,2,0
12/27/2017 6:10,41,67.7,62,63,103,64.9,2,0
12/27/2017 6:15,48,68.7,68,64,116,65.9,2,0
12/27/2017 6:20,52,68.5,72,63.8,124,65.8,2,0
12/27/2017 6:25,42,68.6,61,63.9,103,65.8,2,0
12/27/2017 6:30,52,67.4,72,62.6,124,64.6,2,0
12/27/2017 6:35,52,65.8,73,60.8,125,62.9,2,0
12/27/2017 6:40,57,68,77,63.1,134,65.2,2,0
12/27/2017 6:45,50,68.4,69,63.6,119,65.6,2,0
12/27/2017 6:50,49,68.4,68,63.6,117,65.6,2,0
12/27/2017 6:55,46,67.9,66,63,112,65,2,0
12/27/2017 7:00,41,68.3,60,63.5,101,65.4,2,0
12/27/2017 7:05,32,68.2,51,63.4,83,65.3,2,0
12/27/2017 7:10,48,68,66,63.2,114,65.2,2,0
12/27/2017 7:15,54,69.1,73,64.4,127,66.4,2,0
12/27/2017 7:20,54,68.7,74,64,128,66,2,0
12/27/2017 7:25,59,69.3,79,64.6,138,66.7,2,0
12/27/2017 7:30,55,70,74,65.4,129,67.4,2,0
12/27/2017 7:35,63,69.4,83,64.7,146,66.7,2,0
12/27/2017 7:40,53,67.9,72,63.1,125,65.1,2,0
12/27/2017 7:45,64,67.6,85,62.7,149,64.8,2,0
12/27/2017 7:50,65,66.6,85,61.7,150,63.8,2,0
12/27/2017 7:55,59,68.1,78,63.4,137,65.4,2,0
12/27/2017 8:00,48,68.9,67,64.2,115,66.2,2,0
12/27/2017 8:05,47,68.4,66,63.8,113,65.7,2,0
12/27/2017 8:10,61,68.3,81,63.6,142,65.6,2,0
12/27/2017 8:15,48,68.9,66,64.2,114,66.2,2,0
12/27/2017 8:20,56,69.8,75,65.2,131,67.1,2,0
12/27/2017 8:25,46,69.3,64,64.6,110,66.6,2,0
12/27/2017 8:30,49,69,68,64.3,117,66.3,2,0
12/27/2017 8:35,51,70.3,69,65.7,120,67.6,2,0
12/27/2017 8:40,55,70.4,74,65.9,129,67.9,2,0
12/27/2017 8:45,52,69,71,64.4,123,66.4,2,0
12/27/2017 8:50,47,68.8,66,64.2,113,66.1,2,0
12/27/2017 8:55,55,68.1,75,63.4,130,65.4,2,0
12/27/2017 9:00,46,68.9,64,64.3,110,66.2,2,0
12/27/2017 9:05,54,68.1,74,63.4,128,65.4,2,0
12/27/2017 9:10,44,68,63,63.3,107,65.2,2,0
12/27/2017 9:15,53,68.2,71,63.5,124,65.5,2,0
12/27/2017 9:20,51,68.3,69,63.6,120,65.6,2,0
12/27/2017 9:25,58,67.8,77,63.2,135,65.2,2,0
12/27/2017 9:30,56,69,75,64.5,131,66.4,2,0
12/27/2017 9:35,49,69.9,68,65.4,117,67.3,2,0
12/27/2017 9:40,55,69.7,73,65.2,128,67.1,2,0
12/27/2017 9:45,60,67.4,80,62.7,140,64.7,2,0
12/27/2017 9:50,59,67.8,79,63.1,138,65.1,2,0
12/27/2017 9:55,60,68.2,79,63.6,139,65.6,2,0
12/27/2017 10:00,51,67.6,69,62.8,120,64.8,2,0
12/27/2017 10:05,65,68.1,85,63.4,150,65.4,2,0
12/27/2017 10:10,51,69.1,68,64.5,119,66.5,2,0
12/27/2017 10:15,68,68.4,88,63.8,156,65.8,2,0
12/27/2017 10:20,62,67.7,80,63.1,142,65.1,2,0
12/27/2017 10:25,54,68.2,72,63.5,126,65.5,2,0
12/27/2017 10:30,55,66.2,73,61.3,128,63.4,2,0
12/27/2017 10:35,70,65.7,89,60.9,159,63,2,0
12/27/2017 10:40,58,66.8,77,61.9,135,64,2,0
12/27/2017 10:45,57,67,75,62.2,132,64.3,2,0
12/27/2017 10:50,58,68.2,77,63.5,135,65.5,2,0
12/27/2017 10:55,56,68.3,74,63.6,130,65.6,2,0
12/27/2017 11:00,52,67.2,71,62.4,123,64.4,2,0
12/27/2017 11:05,57,67,76,62.3,133,64.3,2,0
12/27/2017 11:10,59,68.1,79,63.3,138,65.4,2,0
12/27/2017 11:15,65,67.7,84,63,149,65.1,2,0
12/27/2017 11:20,63,68.6,81,63.9,144,65.9,2,0
12/27/2017 11:25,68,67.3,89,62.6,157,64.6,2,0
12/27/2017 11:30,54,67.7,73,62.9,127,64.9,2,0
12/27/2017 11:35,63,68.1,82,63.3,145,65.4,2,0
12/27/2017 11:40,50,68.8,68,64.1,118,66.1,2,0
12/27/2017 11:45,64,68.4,82,63.6,146,65.7,2,0
12/27/2017 11:50,53,68.7,72,64,125,66,2,0
12/27/2017 11:55,50,67.5,69,62.8,119,64.8,2,0
12/27/2017 12:00,47,66.9,66,62.1,113,64.1,2,0
12/27/2017 12:05,56,66,75,61,131,63.2,2,0
12/27/2017 12:10,53,67.7,73,62.9,126,65,2,0
12/27/2017 12:15,48,68,66,63.2,114,65.2,2,0
12/27/2017 12:20,60,68.1,78,63.4,138,65.5,2,0
12/27/2017 12:25,55,67.8,74,63,129,65,2,0
12/27/2017 12:30,58,67.9,77,63.2,135,65.2,2,0
12/27/2017 12:35,54,68.1,73,63.4,127,65.4,2,0
12/27/2017 12:40,55,69.3,73,64.7,128,66.7,2,0
12/27/2017 12:45,59,69.8,77,65.2,136,67.2,2,0
12/27/2017 12:50,61,69.8,80,65.2,141,67.2,2,0
12/27/2017 12:55,62,70.5,81,65.9,143,67.9,2,0
12/27/2017 13:00,55,69.6,74,64.9,129,66.9,2,0
12/27/2017 13:05,43,69.5,61,64.8,104,66.8,2,0
12/27/2017 13:10,57,69.6,76,65,133,67,2,0
12/27/2017 13:15,51,70.3,68,65.8,119,67.7,2,0
12/27/2017 13:20,51,69.3,69,64.6,120,66.6,2,0
12/27/2017 13:25,50,70.3,67,65.7,117,67.7,2,0
12/27/2017 13:30,53,70.3,71,65.8,124,67.7,2,0
12/27/2017 13:35,59,69.1,79,64.5,138,66.5,2,0
12/27/2017 13:40,59,69.7,78,65.1,137,67.1,2,0
12/27/2017 13:45,61,69.4,78,64.8,139,66.8,2,0
12/27/2017 13:50,47,69.2,64,64.6,111,66.6,2,0
12/27/2017 13:55,34,69.5,51,65,85,66.8,2,0
12/27/2017 14:00,41,69.8,58,65.2,99,67.1,2,0
12/27/2017 14:05,46,69.6,62,65,108,67,2,0
12/27/2017 14:10,57,68.5,76,63.8,133,65.8,2,0
12/27/2017 14:15,49,67.7,66,62.8,115,64.9,2,0
12/27/2017 14:20,49,69.3,67,64.6,116,66.6,2,0
12/27/2017 14:25,58,69.2,76,64.6,134,66.6,2,0
12/27/2017 14:30,52,68.9,70,64.2,122,66.2,2,0
12/27/2017 14:35,55,68.8,74,64.1,129,66.1,2,0
12/27/2017 14:40,55,67.5,71,62.8,126,64.9,2,0
12/27/2017 14:45,58,66.7,78,61.9,136,64,2,0
12/27/2017 14:50,48,68.5,66,63.8,114,65.8,2,0
12/27/2017 14:55,56,67.9,74,63.2,130,65.2,2,0
12/27/2017 15:00,53,69.8,70,65.2,123,67.2,2,0
12/27/2017 15:05,48,71.2,66,66.8,114,68.7,2,0
12/27/2017 15:10,51,71.2,69,66.8,120,68.7,2,0
12/27/2017 15:15,46,71,64,66.5,110,68.4,2,0
12/27/2017 15:20,50,71.5,67,67.1,117,69,2,0
12/27/2017 15:25,44,70.8,61,66.4,105,68.2,2,0
12/27/2017 15:30,52,70.2,70,65.7,122,67.6,2,0
12/27/2017 15:35,45,70.4,61,65.9,106,67.8,2,0
12/27/2017 15:40,55,70.5,73,65.9,128,67.8,2,0
12/27/2017 15:45,57,69.7,77,65.1,134,67,2,0
12/27/2017 15:50,46,69.8,63,65.1,109,67.1,2,0
12/27/2017 15:55,57,69.8,75,65.1,132,67.2,2,0
12/27/2017 16:00,51,70.5,68,65.9,119,67.9,2,0
12/27/2017 16:05,57,69.7,76,65.2,133,67.1,2,0
12/27/2017 16:10,52,69.8,70,65.2,122,67.1,2,0
12/27/2017 16:15,57,69.5,75,64.9,132,66.9,2,0
12/27/2017 16:20,47,69.4,65,64.8,112,66.8,2,0
12/27/2017 16:25,49,69.6,67,65.1,116,67,2,0
12/27/2017 16:30,49,69.8,67,65.3,116,67.2,2,0
12/27/2017 16:35,58,69.9,76,65.3,134,67.3,2,0
12/27/2017 16:40,50,70.5,68,66,118,67.9,2,0
12/27/2017 16:45,47,69.9,65,65.3,112,67.2,2,0
12/27/2017 16:50,42,69.8,58,65.2,100,67.1,2,0
12/27/2017 16:55,54,68.7,73,64,127,66,2,0
12/27/2017 17:00,45,69.1,64,64.4,109,66.3,2,0
12/27/2017 17:05,51,69.1,68,64.5,119,66.5,2,0
12/27/2017 17:10,50,69.7,68,65.1,118,67.1,2,0
12/27/2017 17:15,52,69.6,70,65,122,66.9,2,0
12/27/2017 17:20,51,69.8,69,65.2,120,67.2,2,0
12/27/2017 17:25,48,69.4,66,64.7,114,66.7,2,0
12/27/2017 17:30,49,69.5,67,64.7,116,66.7,2,0
12/27/2017 17:35,48,69.5,66,64.8,114,66.8,2,0
12/27/2017 17:40,46,69.9,64,65.3,110,67.2,2,0
12/27/2017 17:45,45,69.6,63,65,108,66.9,2,0
12/27/2017 17:50,45,69.5,62,64.9,107,66.8,2,0
12/27/2017 17:55,46,69.1,64,64.5,110,66.4,2,0
12/27/2017 18:00,39,68.1,57,63.4,96,65.3,2,0
12/27/2017 18:05,45,67.6,63,62.9,108,64.9,2,0
12/27/2017 18:10,49,67.9,67,63.2,116,65.2,2,0
12/27/2017 18:15,48,68.1,67,63.4,115,65.4,2,0
12/27/2017 18:20,39,69.3,56,64.8,95,66.6,2,0
12/27/2017 18:25,56,70.4,73,66,129,67.9,2,0
12/27/2017 18:30,52,69.9,69,65.4,121,67.3,2,0
12/27/2017 18:35,62,69.8,80,65.3,142,67.3,2,0
12/27/2017 18:40,55,70,73,65.5,128,67.4,2,0
12/27/2017 18:45,46,70.1,64,65.6,110,67.4,2,0
12/27/2017 18:50,43,69.4,60,64.8,103,66.7,2,0
12/27/2017 18:55,41,69.9,57,65.3,98,67.2,2,0
12/27/2017 19:00,43,70.1,59,65.5,102,67.4,2,0
12/27/2017 19:05,45,68.9,61,64.3,106,66.3,2,0
12/27/2017 19:10,40,69.5,57,64.9,97,66.8,2,0
12/27/2017 19:15,41,68.4,58,63.7,99,65.6,2,0
12/27/2017 19:20,35,69.4,51,64.7,86,66.6,2,0
12/27/2017 19:25,31,69.6,47,65,78,66.8,2,0
12/27/2017 19:30,29,69.5,45,64.9,74,66.7,2,0
12/27/2017 19:35,28,70.1,44,65.5,72,67.3,2,0
12/27/2017 19:40,36,70,52,65.4,88,67.3,2,0
12/27/2017 19:45,28,69.9,44,65.3,72,67.1,2,0
12/27/2017 19:50,33,70.2,50,65.6,83,67.4,2,0
12/27/2017 19:55,28,69.3,44,64.7,72,66.5,2,0
12/27/2017 20:00,26,69.5,42,64.9,68,66.7,2,0
12/27/2017 20:05,30,69.9,46,65.4,76,67.2,2,0
12/27/2017 20:10,27,70,42,65.4,69,67.2,2,0
12/27/2017 20:15,25,69,41,64.4,66,66.1,2,0
12/27/2017 20:20,36,69.3,53,64.7,89,66.5,2,0
12/27/2017 20:25,29,69.9,44,65.3,73,67.1,2,0
12/27/2017 20:30,26,69.9,42,65.3,68,67.1,2,0
12/27/2017 20:35,27,69.8,43,65.2,70,67,2,0
12/27/2017 20:40,24,69.8,40,65.2,64,66.9,2,0
12/27/2017 20:45,27,69.8,42,65.3,69,67.1,2,0
12/27/2017 20:50,26,68.9,42,64.3,68,66.1,2,0
12/27/2017 20:55,23,68.8,39,64.1,62,65.8,2,0
12/27/2017 21:00,26,69.4,42,64.8,68,66.6,2,0
12/27/2017 21:05,28,69.3,45,64.7,73,66.4,2,0
12/27/2017 21:10,28,69.7,44,65.1,72,66.9,2,0
12/27/2017 21:15,31,69.8,48,65.2,79,67,2,0
12/27/2017 21:20,29,70,45,65.4,74,67.2,2,0
12/27/2017 21:25,25,69.9,41,65.3,66,67,2,0
12/27/2017 21:30,27,69.3,43,64.7,70,66.4,2,0
12/27/2017 21:35,28,69.6,44,65,72,66.7,2,0
12/27/2017 21:40,25,69.6,41,65,66,66.7,2,0
12/27/2017 21:45,27,69.8,43,65.2,70,67,2,0
12/27/2017 21:50,22,69.7,39,65.1,61,66.8,2,0
12/27/2017 21:55,25,69.1,41,64.5,66,66.3,2,0
12/27/2017 22:00,24,69.4,40,64.8,64,66.5,2,0
12/27/2017 22:05,22,69.4,38,64.8,60,66.5,2,0
12/27/2017 22:10,25,69.4,41,64.8,66,66.5,2,0
12/27/2017 22:15,25,69.2,41,64.6,66,66.4,2,0
12/27/2017 22:20,21,69.4,36,64.8,57,66.5,2,0
12/27/2017 22:25,24,69.4,39,64.8,63,66.5,2,0
12/27/2017 22:30,20,69.4,35,64.8,55,66.5,2,0
12/27/2017 22:35,21,69.3,37,64.7,58,66.4,2,0
12/27/2017 22:40,19,69.4,35,64.8,54,66.5,2,0
12/27/2017 22:45,22,69.3,39,64.6,61,66.3,2,0
12/27/2017 22:50,21,69.5,37,64.9,58,66.6,2,0
12/27/2017 22:55,23,69.3,38,64.7,61,66.4,2,0
12/27/2017 23:00,16,69.4,31,64.8,47,66.4,2,0
12/27/2017 23:05,17,68.9,33,64.3,50,65.9,2,0
12/27/2017 23:10,16,69.1,31,64.4,47,66,2,0
12/27/2017 23:15,15,69.2,30,64.6,45,66.2,2,0
12/27/2017 23:20,14,69.3,29,64.7,43,66.2,2,0
12/27/2017 23:25,11,69.4,27,64.8,38,66.1,2,0
12/27/2017 23:30,17,69.4,33,64.8,50,66.3,2,0
12/27/2017 23:35,18,69.3,34,64.7,52,66.3,2,0
12/27/2017 23:40,13,69.4,29,64.8,42,66.3,2,0
12/27/2017 23:45,17,69.5,34,64.9,51,66.4,2,0
12/27/2017 23:50,15,68.8,31,64.1,46,65.7,2,0
12/27/2017 23:55,18,69.3,33,64.6,51,66.3,2,0
12/28/2017 0:00,13,69.3,28,64.7,41,66.2,2,0
12/28/2017 0:05,10,69.4,26,64.8,36,66.1,2,0
12/28/2017 0:10,9,69.4,24,64.8,33,66.1,2,0
12/28/2017 0:15,14,68.9,30,64.3,44,65.8,2,0
12/28/2017 0:20,9,69.1,24,64.4,33,65.7,2,0
12/28/2017 0:25,10,69.3,25,64.7,35,66,2,0
12/28/2017 0:30,17,69.4,23,64.8,40,66.7,2,0
12/28/2017 0:35,10,69.3,26,64.7,36,66,2,0
12/28/2017 0:40,10,69.3,25,64.7,35,66,2,0
12/28/2017 0:45,8,69.3,24,64.6,32,65.8,2,0
12/28/2017 0:50,10,69.3,25,64.7,35,66,2,0
12/28/2017 0:55,10,69.5,25,64.9,35,66.2,2,0
12/28/2017 1:00,8,69.5,24,64.9,32,66.1,2,0
12/28/2017 1:05,17,69.5,23,64.9,40,66.9,2,0
12/28/2017 1:10,7,69.4,23,64.8,30,65.9,2,0
12/28/2017 1:15,6,69.4,21,64.8,27,65.8,2,0
12/28/2017 1:20,10,69.3,20,64.7,30,66.3,2,0
12/28/2017 1:25,9,69.4,24,64.8,33,66.1,2,0
12/28/2017 1:30,6,69.4,22,64.8,28,65.8,2,0
12/28/2017 1:35,7,69.4,23,64.8,30,65.8,2,0
12/28/2017 1:40,7,69.4,22,64.8,29,65.9,2,0
12/28/2017 1:45,7,69.5,22,64.9,29,66,2,0
12/28/2017 1:50,10,69.3,20,64.7,30,66.2,2,0
12/28/2017 1:55,8,69.3,23,64.7,31,65.9,2,0
12/28/2017 2:00,7,69.4,22,64.8,29,65.9,2,0
12/28/2017 2:05,13,69.4,21,64.8,34,66.5,2,0
12/28/2017 2:10,8,69.5,24,64.9,32,66,2,0
12/28/2017 2:15,7,69.4,22,64.8,29,66,2,0
12/28/2017 2:20,5,69.1,20,64.5,25,65.4,2,0
12/28/2017 2:25,7,69,22,64.4,29,65.5,2,0
12/28/2017 2:30,8,68.9,24,64.3,32,65.4,2,0
12/28/2017 2:35,7,69.1,22,64.5,29,65.6,2,0
12/28/2017 2:40,8,69.3,23,64.7,31,65.8,2,0
12/28/2017 2:45,10,68.9,25,64.3,35,65.6,2,0
12/28/2017 2:50,9,69.1,24,64.5,33,65.7,2,0
12/28/2017 2:55,9,68.8,24,64.2,33,65.4,2,0
12/28/2017 3:00,10,69,25,64.4,35,65.7,2,0
12/28/2017 3:05,11,68.8,27,64.1,38,65.5,2,0
12/28/2017 3:10,7,69.1,22,64.5,29,65.6,2,0
12/28/2017 3:15,10,69.3,25,64.7,35,66,2,0
12/28/2017 3:20,10,69.2,25,64.6,35,65.9,2,0
12/28/2017 3:25,9,69.3,25,64.7,34,66,2,0
12/28/2017 3:30,12,69.1,28,64.5,40,65.9,2,0
12/28/2017 3:35,12,69.3,27,64.7,39,66.1,2,0
12/28/2017 3:40,14,69.4,30,64.8,44,66.2,2,0
12/28/2017 3:45,15,69.6,31,65,46,66.5,2,0
12/28/2017 3:50,17,69.6,33,65,50,66.6,2,0
12/28/2017 3:55,11,69.2,27,64.6,38,66,2,0
12/28/2017 4:00,14,69.3,30,64.7,44,66.1,2,0
12/28/2017 4:05,15,69.1,31,64.5,46,66,2,0
12/28/2017 4:10,17,68.5,33,63.9,50,65.5,2,0
12/28/2017 4:15,19,68.6,35,63.9,54,65.6,2,0
12/28/2017 4:20,23,69.2,39,64.5,62,66.3,2,0
12/28/2017 4:25,21,69.3,37,64.7,58,66.4,2,0
12/28/2017 4:30,20,69.4,37,64.8,57,66.4,2,0
12/28/2017 4:35,27,69.6,43,65,70,66.8,2,0
12/28/2017 4:40,30,69.7,47,65.1,77,66.9,2,0
12/28/2017 4:45,31,69.9,48,65.3,79,67.1,2,0
12/28/2017 4:50,29,69.6,47,65.1,76,66.8,2,0
12/28/2017 4:55,35,70.3,52,65.8,87,67.6,2,0
12/28/2017 5:00,37,69.3,55,64.8,92,66.6,2,0
12/28/2017 5:05,32,69.4,50,64.9,82,66.7,2,0
12/28/2017 5:10,39,69.8,57,65.3,96,67.1,2,0
12/28/2017 5:15,40,70.5,58,66,98,67.8,2,0
12/28/2017 5:20,41,69.9,60,65.4,101,67.2,2,0
12/28/2017 5:25,39,68.9,57,64.2,96,66.1,2,0
12/28/2017 5:30,41,68.9,59,64.3,100,66.2,2,0
12/28/2017 5:35,53,68.5,73,63.8,126,65.8,2,0
12/28/2017 5:40,46,68.8,65,64.1,111,66,2,0
12/28/2017 5:45,50,68.8,69,64.1,119,66.1,2,0
12/28/2017 5:50,50,69.4,69,64.8,119,66.7,2,0
12/28/2017 5:55,43,67.7,62,63,105,65,2,0
12/28/2017 6:00,38,67.4,56,62.7,94,64.6,2,0
12/28/2017 6:05,50,67.8,69,63.2,119,65.1,2,0
12/28/2017 6:10,44,68.8,62,64.2,106,66.1,2,0
12/28/2017 6:15,44,68.7,64,64,108,65.9,2,0
12/28/2017 6:20,56,67.6,75,62.9,131,64.9,2,0
12/28/2017 6:25,42,68,61,63.3,103,65.2,2,0
12/28/2017 6:30,55,68.2,74,63.4,129,65.5,2,0
12/28/2017 6:35,49,68.5,70,63.9,119,65.8,2,0
12/28/2017 6:40,63,67.8,84,63,147,65.1,2,0
12/28/2017 6:45,56,68.1,76,63.4,132,65.4,2,0
12/28/2017 6:50,54,67,73,62.2,127,64.2,2,0
12/28/2017 6:55,47,67,67,62.3,114,64.2,2,0
12/28/2017 7:00,48,67.9,67,63.1,115,65.1,2,0
12/28/2017 7:05,42,69.4,59,64.8,101,66.7,2,0
12/28/2017 7:10,44,68.7,62,64,106,65.9,2,0
12/28/2017 7:15,55,68.4,74,63.6,129,65.6,2,0
12/28/2017 7:20,53,67.5,73,62.8,126,64.8,2,0
12/28/2017 7:25,53,68.3,73,63.6,126,65.6,2,0
12/28/2017 7:30,59,68.9,80,64.3,139,66.3,2,0
12/28/2017 7:35,61,69.1,81,64.5,142,66.5,2,0
12/28/2017 7:40,51,69.4,70,64.8,121,66.7,2,0
12/28/2017 7:45,64,68.7,84,64.1,148,66.1,2,0
12/28/2017 7:50,56,69.3,76,64.8,132,66.7,2,0
12/28/2017 7:55,55,69.9,74,65.3,129,67.2,2,0
12/28/2017 8:00,50,69,68,64.4,118,66.3,2,0
12/28/2017 8:05,54,68.2,73,63.5,127,65.5,2,0
12/28/2017 8:10,57,68.6,77,63.8,134,65.9,2,0
12/28/2017 8:15,53,68.9,73,64.2,126,66.2,2,0
12/28/2017 8:20,49,68.5,68,63.9,117,65.8,2,0
12/28/2017 8:25,52,68.6,71,64,123,65.9,2,0
12/28/2017 8:30,56,67.6,75,63,131,65,2,0
12/28/2017 8:35,62,66.9,81,62.2,143,64.2,2,0
12/28/2017 8:40,57,67.6,75,63,132,65,2,0
12/28/2017 8:45,56,67.9,75,63.2,131,65.2,2,0
12/28/2017 8:50,54,68.7,72,64,126,66,2,0
12/28/2017 8:55,50,68.6,68,63.9,118,65.9,2,0
12/28/2017 9:00,59,68.5,78,63.8,137,65.8,2,0
12/28/2017 9:05,43,67.5,61,62.7,104,64.7,2,0
12/28/2017 9:10,53,67.9,71,63.1,124,65.2,2,0
12/28/2017 9:15,48,67.8,68,62.9,116,64.9,2,0
12/28/2017 9:20,47,67.5,65,62.7,112,64.7,2,0
12/28/2017 9:25,53,67.1,72,62.3,125,64.3,2,0
12/28/2017 9:30,57,66.7,76,61.8,133,63.9,2,0
12/28/2017 9:35,51,67.2,69,62.4,120,64.5,2,0
12/28/2017 9:40,55,67.9,73,63.1,128,65.2,2,0
12/28/2017 9:45,60,68,79,63.2,139,65.3,2,0
12/28/2017 9:50,46,68.4,64,63.7,110,65.6,2,0
12/28/2017 9:55,62,68.3,82,63.6,144,65.6,2,0
12/28/2017 10:00,48,68,65,63.4,113,65.3,2,0
12/28/2017 10:05,52,67.6,71,62.9,123,64.9,2,0
12/28/2017 10:10,56,68,75,63.4,131,65.4,2,0
12/28/2017 10:15,59,67.3,77,62.6,136,64.6,2,0
12/28/2017 10:20,57,68.4,75,63.8,132,65.7,2,0
12/28/2017 10:25,65,68.3,85,63.7,150,65.7,2,0
12/28/2017 10:30,51,67.8,69,63.2,120,65.1,2,0
12/28/2017 10:35,57,66.6,76,61.7,133,63.8,2,0
12/28/2017 10:40,55,67.3,74,62.6,129,64.6,2,0
12/28/2017 10:45,60,68.3,79,63.7,139,65.7,2,0
12/28/2017 10:50,53,68.7,71,64.1,124,66.1,2,0
12/28/2017 10:55,54,69.7,72,65.2,126,67.1,2,0
12/28/2017 11:00,61,69.5,79,64.9,140,66.9,2,0
12/28/2017 11:05,60,67.6,79,62.9,139,64.9,2,0
12/28/2017 11:10,65,67.8,85,63.1,150,65.1,2,0
12/28/2017 11:15,59,68.3,78,63.6,137,65.6,2,0
12/28/2017 11:20,68,66.9,89,62.1,157,64.2,2,0
12/28/2017 11:25,58,67.6,78,62.8,136,64.8,2,0
12/28/2017 11:30,56,67.9,75,63.3,131,65.3,2,0
12/28/2017 11:35,55,68.4,73,63.8,128,65.8,2,0
12/28/2017 11:40,50,68,69,63.3,119,65.3,2,0
12/28/2017 11:45,56,67.3,74,62.6,130,64.6,2,0
12/28/2017 11:50,58,67.1,77,62.3,135,64.4,2,0
12/28/2017 11:55,48,68.2,65,63.6,113,65.6,2,0
12/28/2017 12:00,45,68.6,62,64.1,107,66,2,0
12/28/2017 12:05,44,68.2,62,63.5,106,65.4,2,0
12/28/2017 12:10,57,68.4,75,63.7,132,65.7,2,0
12/28/2017 12:15,60,68.6,79,63.9,139,65.9,2,0
12/28/2017 12:20,57,69,75,64.4,132,66.4,2,0
12/28/2017 12:25,51,69.4,70,64.8,121,66.7,2,0
12/28/2017 12:30,59,70,78,65.5,137,67.4,2,0
12/28/2017 12:35,59,69.1,78,64.4,137,66.4,2,0
12/28/2017 12:40,53,68.5,72,63.7,125,65.8,2,0
12/28/2017 12:45,46,69,64,64.3,110,66.3,2,0
12/28/2017 12:50,61,69.4,79,64.8,140,66.8,2,0
12/28/2017 12:55,56,70.8,75,66.3,131,68.2,2,0
12/28/2017 13:00,56,69.5,74,64.9,130,66.9,2,0
12/28/2017 13:05,55,70,72,65.4,127,67.4,2,0
12/28/2017 13:10,59,69.6,78,65,137,67,2,0
12/28/2017 13:15,59,70.1,77,65.5,136,67.5,2,0
12/28/2017 13:20,59,70.8,77,66.2,136,68.2,2,0
12/28/2017 13:25,51,69.7,70,65,121,67,2,0
12/28/2017 13:30,54,71.1,72,66.6,126,68.5,2,0
12/28/2017 13:35,60,70.7,78,66.1,138,68.1,2,0
12/28/2017 13:40,57,70,75,65.4,132,67.4,2,0
12/28/2017 13:45,51,70.7,68,66.1,119,68,2,0
12/28/2017 13:50,61,71,80,66.4,141,68.4,2,0
12/28/2017 13:55,47,71.7,65,67.2,112,69.1,2,0
12/28/2017 14:00,50,69.3,68,64.6,118,66.6,2,0
12/28/2017 14:05,51,69.2,69,64.6,120,66.6,2,0
12/28/2017 14:10,46,68.9,64,64.3,110,66.2,2,0
12/28/2017 14:15,47,69.1,65,64.5,112,66.5,2,0
12/28/2017 14:20,50,68.2,69,63.5,119,65.5,2,0
12/28/2017 14:25,55,67.1,74,62.5,129,64.5,2,0
12/28/2017 14:30,39,67.2,56,62.5,95,64.4,2,0
12/28/2017 14:35,53,67.9,70,63.2,123,65.2,2,0
12/28/2017 14:40,50,68.8,67,64.2,117,66.1,2,0
12/28/2017 14:45,49,69.7,66,65.2,115,67.1,2,0
12/28/2017 14:50,59,68.5,77,63.9,136,65.9,2,0
12/28/2017 14:55,48,68.4,65,63.9,113,65.8,2,0
12/28/2017 15:00,42,69.1,59,64.6,101,66.5,2,0
12/28/2017 15:05,52,69.8,69,65.3,121,67.2,2,0
12/28/2017 15:10,51,69.3,68,64.8,119,66.7,2,0
12/28/2017 15:15,59,70.5,77,66,136,67.9,2,0
12/28/2017 15:20,52,70.3,69,65.8,121,67.7,2,0
12/28/2017 15:25,64,69.7,82,65.1,146,67.1,2,0
12/28/2017 15:30,52,69.2,69,64.6,121,66.6,2,0
12/28/2017 15:35,63,69.2,81,64.6,144,66.6,2,0
12/28/2017 15:40,52,70.1,71,65.6,123,67.5,2,0
12/28/2017 15:45,48,70.6,66,66.1,114,68,2,0
12/28/2017 15:50,48,70.3,66,65.8,114,67.7,2,0
12/28/2017 15:55,52,70.3,70,65.8,122,67.7,2,0
12/28/2017 16:00,46,70.7,64,66.2,110,68.1,2,0
12/28/2017 16:05,51,71.5,68,67.1,119,69,2,0
12/28/2017 16:10,48,71.5,65,67.1,113,69,2,0
12/28/2017 16:15,47,70.8,65,66.4,112,68.3,2,0
12/28/2017 16:20,40,71.7,57,67.4,97,69.2,2,0
12/28/2017 16:25,55,71,73,66.6,128,68.4,2,0
12/28/2017 16:30,45,70.5,63,66,108,67.9,2,0
12/28/2017 16:35,52,70.7,70,66.2,122,68.1,2,0
12/28/2017 16:40,47,71.3,64,67,111,68.8,2,0
12/28/2017 16:45,46,71.5,64,67.1,110,69,2,0
12/28/2017 16:50,56,71,74,66.5,130,68.4,2,0
12/28/2017 16:55,49,70.5,67,66,116,67.9,2,0
12/28/2017 17:00,47,70.6,64,66,111,67.9,2,0
12/28/2017 17:05,45,70.1,62,65.6,107,67.5,2,0
12/28/2017 17:10,48,69.2,66,64.6,114,66.5,2,0
12/28/2017 17:15,49,69.4,68,64.8,117,66.7,2,0
12/28/2017 17:20,54,69.7,72,65.2,126,67.2,2,0
12/28/2017 17:25,48,69.7,65,65.2,113,67.1,2,0
12/28/2017 17:30,49,69.6,67,64.9,116,66.9,2,0
12/28/2017 17:35,43,70,60,65.4,103,67.3,2,0
12/28/2017 17:40,43,69.1,61,64.5,104,66.4,2,0
12/28/2017 17:45,48,67.7,66,63,114,64.9,2,0
12/28/2017 17:50,56,69.3,74,64.8,130,66.7,2,0
12/28/2017 17:55,52,69.7,69,65.1,121,67.1,2,0
12/28/2017 18:00,40,70.1,57,65.5,97,67.4,2,0
12/28/2017 18:05,41,70.1,57,65.5,98,67.4,2,0
12/28/2017 18:10,50,69.9,67,65.4,117,67.3,2,0
12/28/2017 18:15,47,70.3,65,65.9,112,67.8,2,0
12/28/2017 18:20,43,70.6,60,66.1,103,68,2,0
12/28/2017 18:25,51,69.7,68,65.1,119,67.1,2,0
12/28/2017 18:30,42,69.3,59,64.8,101,66.7,2,0
12/28/2017 18:35,44,69.8,61,65.3,105,67.2,2,0
12/28/2017 18:40,44,70.5,61,66,105,67.9,2,0
12/28/2017 18:45,38,71.5,54,67,92,68.8,2,0
12/28/2017 18:50,40,70.6,57,66.1,97,67.9,2,0
12/28/2017 18:55,36,70.2,53,65.6,89,67.5,2,0
12/28/2017 19:00,35,69.5,50,64.9,85,66.8,2,0
12/28/2017 19:05,38,70.2,55,65.6,93,67.5,2,0
12/28/2017 19:10,39,69.7,55,65.1,94,67,2,0
12/28/2017 19:15,34,70.4,50,65.9,84,67.7,2,0
12/28/2017 19:20,46,70.1,63,65.7,109,67.5,2,0
12/28/2017 19:25,38,70.2,55,65.7,93,67.6,2,0
12/28/2017 19:30,39,70.7,56,66.2,95,68,2,0
12/28/2017 19:35,35,70.9,52,66.4,87,68.2,2,0
12/28/2017 19:40,33,70.7,50,66.2,83,68,2,0
12/28/2017 19:45,29,69.3,46,64.7,75,66.5,2,0
12/28/2017 19:50,28,69.6,44,65,72,66.8,2,0
12/28/2017 19:55,26,69.8,42,65.2,68,67,2,0
12/28/2017 20:00,33,69.7,49,65.1,82,67,2,0
12/28/2017 20:05,28,69.3,45,64.7,73,66.5,2,0
12/28/2017 20:10,25,69.1,41,64.5,66,66.3,2,0
12/28/2017 20:15,31,68.9,49,64.3,80,66.1,2,0
12/28/2017 20:20,30,68.5,46,63.8,76,65.7,2,0
12/28/2017 20:25,31,69.6,47,65,78,66.8,2,0
12/28/2017 20:30,24,69.7,40,65.1,64,66.8,2,0
12/28/2017 20:35,25,68.9,41,64.3,66,66,2,0
12/28/2017 20:40,29,68.8,46,64.1,75,65.9,2,0
12/28/2017 20:45,31,69.2,47,64.6,78,66.4,2,0
12/28/2017 20:50,26,69.4,42,64.8,68,66.5,2,0
12/28/2017 20:55,25,69.6,41,65,66,66.7,2,0
12/28/2017 21:00,28,69.6,45,65,73,66.7,2,0
12/28/2017 21:05,26,69,41,64.4,67,66.1,2,0
12/28/2017 21:10,32,68.7,48,64,80,65.9,2,0
12/28/2017 21:15,26,69,42,64.4,68,66.1,2,0
12/28/2017 21:20,28,68.7,43,64.1,71,65.9,2,0
12/28/2017 21:25,28,68.9,44,64.3,72,66.1,2,0
12/28/2017 21:30,26,69.3,42,64.7,68,66.5,2,0
12/28/2017 21:35,26,69.1,42,64.5,68,66.3,2,0
12/28/2017 21:40,27,69.5,43,64.9,70,66.7,2,0
12/28/2017 21:45,20,69.3,37,64.7,57,66.3,2,0
12/28/2017 21:50,23,69.5,39,64.9,62,66.6,2,0
12/28/2017 21:55,18,69.3,34,64.7,52,66.3,2,0
12/28/2017 22:00,26,69.3,42,64.7,68,66.4,2,0
12/28/2017 22:05,22,69.4,37,64.8,59,66.5,2,0
12/28/2017 22:10,21,69.3,37,64.7,58,66.3,2,0
12/28/2017 22:15,23,69.4,39,64.8,62,66.5,2,0
12/28/2017 22:20,26,69.3,42,64.7,68,66.5,2,0
12/28/2017 22:25,23,69.3,38,64.7,61,66.4,2,0
12/28/2017 22:30,23,68.9,39,64.3,62,66,2,0
12/28/2017 22:35,20,69.1,36,64.5,56,66.1,2,0
12/28/2017 22:40,22,69.2,38,64.7,60,66.3,2,0
12/28/2017 22:45,20,69.4,36,64.8,56,66.4,2,0
12/28/2017 22:50,21,69.7,37,65.2,58,66.8,2,0
12/28/2017 22:55,15,69.7,31,65.1,46,66.6,2,0
12/28/2017 23:00,19,69.1,34,64.5,53,66.1,2,0
12/28/2017 23:05,15,69.3,31,64.7,46,66.2,2,0
12/28/2017 23:10,18,69.4,34,64.8,52,66.4,2,0
12/28/2017 23:15,16,69.5,32,64.9,48,66.5,2,0
12/28/2017 23:20,15,69.4,30,64.7,45,66.3,2,0
12/28/2017 23:25,15,69.1,30,64.5,45,66,2,0
12/28/2017 23:30,14,69.1,30,64.5,44,65.9,2,0
12/28/2017 23:35,20,69.3,36,64.7,56,66.3,2,0
12/28/2017 23:40,13,69.5,28,64.9,41,66.3,2,0
12/28/2017 23:45,16,69.6,31,65,47,66.6,2,0
12/28/2017 23:50,13,69.4,28,64.8,41,66.3,2,0
12/28/2017 23:55,18,68.9,33,64.2,51,65.9,2,0
12/29/2017 0:00,15,69.3,30,64.7,45,66.3,2,0
12/29/2017 0:05,14,69.4,30,64.8,44,66.2,2,0
12/29/2017 0:10,13,69.1,28,64.5,41,66,2,0
12/29/2017 0:15,10,69.3,25,64.7,35,66,2,0
12/29/2017 0:20,10,69.1,25,64.5,35,65.8,2,0
12/29/2017 0:25,12,69.3,27,64.7,39,66.2,2,0
12/29/2017 0:30,13,69.3,29,64.7,42,66.1,2,0
12/29/2017 0:35,10,69.3,25,64.7,35,66,2,0
12/29/2017 0:40,7,69.3,23,64.7,30,65.8,2,0
12/29/2017 0:45,9,69.2,24,64.6,33,65.8,2,0
12/29/2017 0:50,9,69.4,24,64.8,33,66.1,2,0
12/29/2017 0:55,10,69.1,26,64.4,36,65.7,2,0
12/29/2017 1:00,7,69.2,23,64.6,30,65.7,2,0
12/29/2017 1:05,9,69.3,24,64.7,33,66,2,0
12/29/2017 1:10,8,69.4,24,64.8,32,66,2,0
12/29/2017 1:15,6,69.4,21,64.8,27,65.9,2,0
12/29/2017 1:20,8,69.4,24,64.8,32,65.9,2,0
12/29/2017 1:25,7,69.4,22,64.8,29,65.9,2,0
12/29/2017 1:30,9,69.4,24,64.8,33,66.1,2,0
12/29/2017 1:35,10,69.2,25,64.5,35,65.9,2,0
12/29/2017 1:40,8,69,23,64.4,31,65.6,2,0
12/29/2017 1:45,9,69.1,24,64.5,33,65.7,2,0
12/29/2017 1:50,8,69,23,64.4,31,65.6,2,0
12/29/2017 1:55,7,69.3,22,64.7,29,65.8,2,0
12/29/2017 2:00,6,69.3,22,64.7,28,65.6,2,0
12/29/2017 2:05,10,69.3,20,64.7,30,66.3,2,0
12/29/2017 2:10,10,69.2,25,64.5,35,65.9,2,0
12/29/2017 2:15,10,69.3,25,64.7,35,66,2,0
12/29/2017 2:20,13,69.4,21,64.8,34,66.6,2,0
12/29/2017 2:25,8,69.4,24,64.8,32,66,2,0
12/29/2017 2:30,8,69.4,23,64.8,31,66,2,0
12/29/2017 2:35,7,69.3,22,64.7,29,65.8,2,0
12/29/2017 2:40,8,69.4,24,64.8,32,65.9,2,0
12/29/2017 2:45,11,69.4,26,64.8,37,66.2,2,0
12/29/2017 2:50,9,69.3,24,64.7,33,65.9,2,0
12/29/2017 2:55,10,69.2,25,64.5,35,65.9,2,0
12/29/2017 3:00,6,69.1,21,64.5,27,65.5,2,0
12/29/2017 3:05,10,69.2,25,64.6,35,65.9,2,0
12/29/2017 3:10,11,69.3,26,64.7,37,66.1,2,0
12/29/2017 3:15,12,69.3,28,64.7,40,66.1,2,0
12/29/2017 3:20,11,69.3,26,64.7,37,66.1,2,0
12/29/2017 3:25,10,69.3,25,64.7,35,66.1,2,0
12/29/2017 3:30,13,69.4,29,64.8,42,66.3,2,0
12/29/2017 3:35,12,69.4,28,64.8,40,66.2,2,0
12/29/2017 3:40,14,69.4,30,64.8,44,66.3,2,0
12/29/2017 3:45,16,69.5,32,65,48,66.5,2,0
12/29/2017 3:50,14,69.6,30,65,44,66.4,2,0
12/29/2017 3:55,13,69.3,28,64.7,41,66.2,2,0
12/29/2017 4:00,12,69.1,28,64.5,40,65.9,2,0
12/29/2017 4:05,13,69.2,29,64.5,42,66,2,0
12/29/2017 4:10,23,68.8,40,64.2,63,65.9,2,0
12/29/2017 4:15,18,69.3,34,64.7,52,66.3,2,0
12/29/2017 4:20,22,69.4,38,64.7,60,66.4,2,0
12/29/2017 4:25,20,69.4,37,64.8,57,66.5,2,0
12/29/2017 4:30,26,69.6,42,65,68,66.8,2,0
12/29/2017 4:35,31,69.4,48,64.8,79,66.7,2,0
12/29/2017 4:40,26,69.6,43,65.1,69,66.8,2,0
12/29/2017 4:45,35,68.9,52,64.3,87,66.2,2,0
12/29/2017 4:50,29,68.5,46,63.8,75,65.6,2,0
12/29/2017 4:55,33,69.5,50,64.9,83,66.7,2,0
12/29/2017 5:00,30,69.3,47,64.7,77,66.5,2,0
12/29/2017 5:05,26,69.8,43,65.2,69,66.9,2,0
12/29/2017 5:10,31,69.5,49,64.9,80,66.7,2,0
12/29/2017 5:15,35,68.7,53,64.1,88,65.9,2,0
12/29/2017 5:20,43,68.7,61,64,104,65.9,2,0
12/29/2017 5:25,41,69.2,60,64.5,101,66.4,2,0
12/29/2017 5:30,37,69.6,55,65.1,92,66.9,2,0
12/29/2017 5:35,35,69,52,64.3,87,66.2,2,0
12/29/2017 5:40,44,69,63,64.3,107,66.2,2,0
12/29/2017 5:45,44,67.5,63,62.6,107,64.6,2,0
12/29/2017 5:50,51,67,70,62.2,121,64.2,2,0
12/29/2017 5:55,46,68.2,65,63.5,111,65.4,2,0
12/29/2017 6:00,51,67.7,70,62.9,121,64.9,2,0
12/29/2017 6:05,38,68,56,63.4,94,65.3,2,0
12/29/2017 6:10,42,69.6,61,65.1,103,66.9,2,0
12/29/2017 6:15,40,70.4,58,66,98,67.8,2,0
12/29/2017 6:20,48,67.6,68,62.9,116,64.8,2,0
12/29/2017 6:25,49,67,68,62.3,117,64.3,2,0
12/29/2017 6:30,44,68.4,62,63.8,106,65.7,2,0
12/29/2017 6:35,52,69,72,64.4,124,66.3,2,0
12/29/2017 6:40,48,68.7,68,64.1,116,66,2,0
12/29/2017 6:45,45,69.4,64,64.9,109,66.8,2,0
12/29/2017 6:50,50,68.9,68,64.3,118,66.2,2,0
12/29/2017 6:55,43,69.1,61,64.5,104,66.4,2,0
12/29/2017 7:00,54,68.7,73,64,127,66,2,0
12/29/2017 7:05,44,69,62,64.4,106,66.3,2,0
12/29/2017 7:10,42,68.8,60,64.1,102,66,2,0
12/29/2017 7:15,50,67.4,70,62.6,120,64.6,2,0
12/29/2017 7:20,53,68.2,71,63.4,124,65.5,2,0
12/29/2017 7:25,51,69.4,70,64.7,121,66.6,2,0
12/29/2017 7:30,57,69.4,75,64.7,132,66.7,2,0
12/29/2017 7:35,56,70.4,76,65.8,132,67.7,2,0
12/29/2017 7:40,59,71,79,66.5,138,68.4,2,0
12/29/2017 7:45,60,71,80,66.5,140,68.4,2,0
12/29/2017 7:50,55,70,74,65.4,129,67.4,2,0
12/29/2017 7:55,49,69.1,68,64.5,117,66.4,2,0
12/29/2017 8:00,46,67.6,65,62.9,111,64.8,2,0
12/29/2017 8:05,47,68,66,63.4,113,65.3,2,0
12/29/2017 8:10,52,67.5,72,62.8,124,64.8,2,0
12/29/2017 8:15,48,68.8,67,64.2,115,66.1,2,0
12/29/2017 8:20,54,68.8,73,64.2,127,66.1,2,0
12/29/2017 8:25,55,69.2,73,64.7,128,66.6,2,0
12/29/2017 8:30,44,69.1,62,64.6,106,66.5,2,0
12/29/2017 8:35,56,68.9,74,64.2,130,66.2,2,0
12/29/2017 8:40,54,69,74,64.4,128,66.3,2,0
12/29/2017 8:45,49,69.3,67,64.7,116,66.6,2,0
12/29/2017 8:50,46,70.3,64,65.8,110,67.7,2,0
12/29/2017 8:55,48,70.4,65,65.9,113,67.8,2,0
12/29/2017 9:00,53,69.4,71,64.9,124,66.8,2,0
12/29/2017 9:05,44,69.2,63,64.7,107,66.6,2,0
12/29/2017 9:10,45,68.1,62,63.5,107,65.4,2,0
12/29/2017 9:15,49,68.4,67,63.7,116,65.7,2,0
12/29/2017 9:20,48,69.3,65,64.7,113,66.7,2,0
12/29/2017 9:25,47,69.8,65,65.3,112,67.2,2,0
12/29/2017 9:30,40,69,58,64.4,98,66.2,2,0
12/29/2017 9:35,53,69.1,71,64.5,124,66.5,2,0
12/29/2017 9:40,57,68,75,63.4,132,65.4,2,0
12/29/2017 9:45,55,68.5,75,63.9,130,65.8,2,0
12/29/2017 9:50,58,68.2,77,63.5,135,65.5,2,0
12/29/2017 9:55,53,69,70,64.4,123,66.4,2,0
12/29/2017 10:00,47,68.7,64,64.1,111,66.1,2,0
12/29/2017 10:05,54,68.9,72,64.4,126,66.3,2,0
12/29/2017 10:10,53,68,72,63.4,125,65.3,2,0
12/29/2017 10:15,54,68,72,63.4,126,65.4,2,0
12/29/2017 10:20,67,67.9,87,63.1,154,65.2,2,0
12/29/2017 10:25,51,68.4,68,63.8,119,65.8,2,0
12/29/2017 10:30,59,67.3,77,62.6,136,64.7,2,0
12/29/2017 10:35,51,68.2,69,63.5,120,65.5,2,0
12/29/2017 10:40,57,68.3,76,63.6,133,65.6,2,0
12/29/2017 10:45,69,68.9,89,64.3,158,66.4,2,0
12/29/2017 10:50,54,69.3,72,64.8,126,66.7,2,0
12/29/2017 10:55,54,68.6,72,64,126,66,2,0
12/29/2017 11:00,54,68,73,63.3,127,65.3,2,0
12/29/2017 11:05,52,67.9,70,63.2,122,65.2,2,0
12/29/2017 11:10,70,67.2,90,62.5,160,64.5,2,0
12/29/2017 11:15,60,67.5,79,62.8,139,64.9,2,0
12/29/2017 11:20,68,67.4,88,62.6,156,64.7,2,0
12/29/2017 11:25,56,67.8,75,63.1,131,65.1,2,0
12/29/2017 11:30,70,68.3,90,63.6,160,65.7,2,0
12/29/2017 11:35,69,67.9,88,63.2,157,65.3,2,0
12/29/2017 11:40,66,68,86,63.3,152,65.4,2,0
12/29/2017 11:45,65,68.1,85,63.4,150,65.4,2,0
12/29/2017 11:50,65,66.7,84,61.9,149,64,2,0
12/29/2017 11:55,63,67.9,81,63.2,144,65.3,2,0
12/29/2017 12:00,48,68,66,63.1,114,65.2,2,0
12/29/2017 12:05,50,67.6,69,62.9,119,64.8,2,0
12/29/2017 12:10,54,68.5,72,63.9,126,65.9,2,0
12/29/2017 12:15,43,68.3,60,63.7,103,65.6,2,0
12/29/2017 12:20,45,69,63,64.4,108,66.3,2,0
12/29/2017 12:25,41,69,58,64.4,99,66.3,2,0
12/29/2017 12:30,49,68.1,67,63.5,116,65.4,2,0
12/29/2017 12:35,50,69.6,68,65.1,118,67,2,0
12/29/2017 12:40,50,68.9,68,64.2,118,66.2,2,0
12/29/2017 12:45,49,67.9,66,63.2,115,65.2,2,0
12/29/2017 12:50,50,68.2,68,63.5,118,65.5,2,0
12/29/2017 12:55,45,69.6,63,65.1,108,66.9,2,0
12/29/2017 13:00,47,70.7,64,66.2,111,68.1,2,0
12/29/2017 13:05,56,70.7,74,66.2,130,68.1,2,0
12/29/2017 13:10,52,69.7,70,65,122,67,2,0
12/29/2017 13:15,57,70,76,65.4,133,67.4,2,0
12/29/2017 13:20,54,69.6,72,65,126,67,2,0
12/29/2017 13:25,63,69.3,82,64.7,145,66.7,2,0
12/29/2017 13:30,60,69.4,79,64.7,139,66.7,2,0
12/29/2017 13:35,63,70.7,81,66.2,144,68.2,2,0
12/29/2017 13:40,61,70.6,78,66.1,139,68.1,2,0
12/29/2017 13:45,64,69.8,84,65.3,148,67.3,2,0
12/29/2017 13:50,55,70,73,65.5,128,67.4,2,0
12/29/2017 13:55,49,68.9,67,64.3,116,66.2,2,0
12/29/2017 14:00,53,68.4,71,63.8,124,65.8,2,0
12/29/2017 14:05,52,67.6,70,62.8,122,64.9,2,0
12/29/2017 14:10,55,67.8,73,63,128,65.1,2,0
12/29/2017 14:15,48,68,66,63.3,114,65.3,2,0
12/29/2017 14:20,51,68.6,70,63.8,121,65.8,2,0
12/29/2017 14:25,46,69.4,63,64.7,109,66.7,2,0
12/29/2017 14:30,57,68.7,76,64,133,66,2,0
12/29/2017 14:35,55,68.1,72,63.3,127,65.3,2,0
12/29/2017 14:40,52,68.3,71,63.6,123,65.6,2,0
12/29/2017 14:45,49,68.9,68,64.2,117,66.2,2,0
12/29/2017 14:50,50,68.8,68,64.1,118,66,2,0
12/29/2017 14:55,51,68.2,69,63.5,120,65.5,2,0
12/29/2017 15:00,61,68.7,80,64.1,141,66.1,2,0
12/29/2017 15:05,47,68.9,66,64.4,113,66.3,2,0
12/29/2017 15:10,54,69.3,72,64.7,126,66.7,2,0
12/29/2017 15:15,59,68.4,78,63.7,137,65.7,2,0
12/29/2017 15:20,60,68.7,78,64,138,66,2,0
12/29/2017 15:25,36,69.9,53,65.4,89,67.2,2,0
12/29/2017 15:30,44,69.8,61,65.2,105,67.1,2,0
12/29/2017 15:35,50,70.3,67,65.8,117,67.8,2,0
12/29/2017 15:40,54,71,72,66.6,126,68.5,2,0
12/29/2017 15:45,59,70.7,77,66.3,136,68.2,2,0
12/29/2017 15:50,55,70,74,65.5,129,67.4,2,0
12/29/2017 15:55,52,69.8,70,65.3,122,67.3,2,0
12/29/2017 16:00,50,70.2,68,65.7,118,67.6,2,0
12/29/2017 16:05,48,70.3,66,65.8,114,67.7,2,0
12/29/2017 16:10,53,70.7,71,66.2,124,68.1,2,0
12/29/2017 16:15,47,70,64,65.5,111,67.4,2,0
12/29/2017 16:20,61,70.6,79,66.2,140,68.1,2,0
12/29/2017 16:25,55,70.5,72,66.1,127,68,2,0
12/29/2017 16:30,57,70.6,76,66.2,133,68.1,2,0
12/29/2017 16:35,56,70.1,74,65.6,130,67.5,2,0
12/29/2017 16:40,51,69.7,69,65.1,120,67.1,2,0
12/29/2017 16:45,56,70.1,74,65.7,130,67.6,2,0
12/29/2017 16:50,59,70.7,77,66.2,136,68.2,2,0
12/29/2017 16:55,63,69.8,81,65.2,144,67.2,2,0
12/29/2017 17:00,51,70.2,69,65.7,120,67.6,2,0
12/29/2017 17:05,50,70,67,65.5,117,67.4,2,0
12/29/2017 17:10,50,69.9,68,65.5,118,67.4,2,0
12/29/2017 17:15,53,70.2,71,65.9,124,67.7,2,0
12/29/2017 17:20,49,69.2,67,64.7,116,66.6,2,0
12/29/2017 17:25,59,69.5,76,65,135,67,2,0
12/29/2017 17:30,54,68.8,73,64.3,127,66.2,2,0
12/29/2017 17:35,52,68.5,70,63.9,122,65.8,2,0
12/29/2017 17:40,56,68.5,74,63.9,130,65.9,2,0
12/29/2017 17:45,51,68.2,69,63.5,120,65.5,2,0
12/29/2017 17:50,55,67.6,74,62.8,129,64.8,2,0
12/29/2017 17:55,60,67.3,77,62.5,137,64.6,2,0
12/29/2017 18:00,62,67.2,80,62.4,142,64.5,2,0
12/29/2017 18:05,51,68.1,69,63.5,120,65.5,2,0
12/29/2017 18:10,53,67.8,70,63,123,65.1,2,0
12/29/2017 18:15,50,68,68,63.3,118,65.3,2,0
12/29/2017 18:20,60,68.2,79,63.6,139,65.6,2,0
12/29/2017 18:25,50,68.2,68,63.6,118,65.5,2,0
12/29/2017 18:30,58,68.1,76,63.4,134,65.5,2,0
12/29/2017 18:35,54,68.6,72,64,126,66,2,0
12/29/2017 18:40,52,68.6,70,64,122,66,2,0
12/29/2017 18:45,50,68.7,68,64.1,118,66,2,0
12/29/2017 18:50,42,69.1,59,64.5,101,66.4,2,0
12/29/2017 18:55,51,68.8,68,64.2,119,66.2,2,0
12/29/2017 19:00,43,69.3,61,64.7,104,66.6,2,0
12/29/2017 19:05,45,68.7,62,64.1,107,66,2,0
12/29/2017 19:10,57,69.1,75,64.5,132,66.5,2,0
12/29/2017 19:15,51,69.4,68,64.8,119,66.8,2,0
12/29/2017 19:20,45,69.2,62,64.6,107,66.6,2,0
12/29/2017 19:25,41,69.5,58,64.9,99,66.8,2,0
12/29/2017 19:30,41,70.2,57,65.7,98,67.6,2,0
12/29/2017 19:35,46,70.6,64,66.1,110,68,2,0
12/29/2017 19:40,39,71.1,56,66.6,95,68.5,2,0
12/29/2017 19:45,34,70.3,50,65.8,84,67.6,2,0
12/29/2017 19:50,30,70.4,47,65.8,77,67.6,2,0
12/29/2017 19:55,34,69.5,50,64.9,84,66.8,2,0
12/29/2017 20:00,28,69.5,44,64.9,72,66.6,2,0
12/29/2017 20:05,37,69.3,53,64.7,90,66.5,2,0
12/29/2017 20:10,37,68.9,55,64.3,92,66.1,2,0
12/29/2017 20:15,38,68.3,55,63.6,93,65.5,2,0
12/29/2017 20:20,27,69.2,43,64.6,70,66.4,2,0
12/29/2017 20:25,34,70,50,65.5,84,67.3,2,0
12/29/2017 20:30,24,69.6,40,65,64,66.7,2,0
12/29/2017 20:35,28,69.7,44,65.1,72,66.9,2,0
12/29/2017 20:40,24,69.5,39,64.9,63,66.7,2,0
12/29/2017 20:45,31,69.4,46,64.8,77,66.6,2,0
12/29/2017 20:50,30,69,46,64.4,76,66.2,2,0
12/29/2017 20:55,30,68.7,47,64,77,65.8,2,0
12/29/2017 21:00,35,69,51,64.4,86,66.2,2,0
12/29/2017 21:05,28,68.9,44,64.3,72,66.1,2,0
12/29/2017 21:10,29,68.6,46,63.9,75,65.7,2,0
12/29/2017 21:15,32,69.2,48,64.6,80,66.5,2,0
12/29/2017 21:20,29,69.4,45,64.8,74,66.6,2,0
12/29/2017 21:25,34,69.1,51,64.5,85,66.4,2,0
12/29/2017 21:30,25,69.3,41,64.7,66,66.4,2,0
12/29/2017 21:35,28,69.3,44,64.7,72,66.5,2,0
12/29/2017 21:40,31,69.7,47,65.1,78,66.9,2,0
12/29/2017 21:45,23,69.8,39,65.2,62,66.9,2,0
12/29/2017 21:50,27,69.3,43,64.7,70,66.4,2,0
12/29/2017 21:55,28,69,44,64.4,72,66.2,2,0
12/29/2017 22:00,24,69.5,40,64.9,64,66.6,2,0
12/29/2017 22:05,23,69.4,39,64.8,62,66.5,2,0
12/29/2017 22:10,27,69.5,42,64.9,69,66.7,2,0
12/29/2017 22:15,30,69.6,46,65,76,66.8,2,0
12/29/2017 22:20,26,69.5,42,64.9,68,66.6,2,0
12/29/2017 22:25,22,69.5,38,64.9,60,66.5,2,0
12/29/2017 22:30,27,69.2,43,64.6,70,66.4,2,0
12/29/2017 22:35,22,69.7,38,65.1,60,66.8,2,0
12/29/2017 22:40,28,69.4,44,64.7,72,66.5,2,0
12/29/2017 22:45,24,69.5,39,64.9,63,66.7,2,0
12/29/2017 22:50,19,69.6,35,65,54,66.6,2,0
12/29/2017 22:55,24,69.8,40,65.2,64,66.9,2,0
12/29/2017 23:00,21,69.2,37,64.6,58,66.3,2,0
12/29/2017 23:05,19,69.3,35,64.7,54,66.3,2,0
12/29/2017 23:10,19,67.7,35,63.1,54,64.7,2,0
12/29/2017 23:15,16,68.1,31,63.4,47,65,2,0
12/29/2017 23:20,17,68.7,32,64.1,49,65.7,2,0
12/29/2017 23:25,15,68.7,30,64.1,45,65.6,2,0
12/29/2017 23:30,19,69.3,35,64.7,54,66.3,2,0
12/29/2017 23:35,18,69.3,33,64.7,51,66.3,2,0
12/29/2017 23:40,17,69.2,33,64.6,50,66.2,2,0
12/29/2017 23:45,19,69.2,35,64.6,54,66.2,2,0
12/29/2017 23:50,15,69.4,31,64.8,46,66.3,2,0
12/29/2017 23:55,23,69.7,38,65.2,61,66.9,2,0
12/30/2017 0:00,17,69.3,32,64.7,49,66.3,2,0
12/30/2017 0:05,15,69.4,30,64.8,45,66.4,2,0
12/30/2017 0:10,13,69.4,29,64.8,42,66.3,2,0
12/30/2017 0:15,12,69.4,28,64.8,40,66.2,2,0
12/30/2017 0:20,11,69.3,26,64.7,37,66.1,2,0
12/30/2017 0:25,12,69.2,27,64.6,39,66,2,0
12/30/2017 0:30,13,69,29,64.4,42,65.8,2,0
12/30/2017 0:35,13,69.2,28,64.5,41,66,2,0
12/30/2017 0:40,14,69,29,64.4,43,65.9,2,0
12/30/2017 0:45,13,69.3,28,64.7,41,66.2,2,0
12/30/2017 0:50,10,69.3,25,64.7,35,66.1,2,0
12/30/2017 0:55,7,69.4,22,64.8,29,65.9,2,0
12/30/2017 1:00,12,69.4,27,64.8,39,66.2,2,0
12/30/2017 1:05,9,69.2,24,64.5,33,65.8,2,0
12/30/2017 1:10,8,69.3,23,64.7,31,65.9,2,0
12/30/2017 1:15,7,69.4,22,64.8,29,65.9,2,0
12/30/2017 1:20,11,69.5,26,64.9,37,66.2,2,0
12/30/2017 1:25,10,69.4,25,64.8,35,66.2,2,0
12/30/2017 1:30,8,69.4,23,64.8,31,66,2,0
12/30/2017 1:35,6,69.3,22,64.7,28,65.7,2,0
12/30/2017 1:40,9,69.3,25,64.7,34,66,2,0
12/30/2017 1:45,8,69.4,23,64.8,31,66,2,0
12/30/2017 1:50,8,69.4,23,64.8,31,66,2,0
12/30/2017 1:55,9,69.5,25,64.9,34,66.1,2,0
12/30/2017 2:00,9,69.5,24,64.9,33,66.1,2,0
12/30/2017 2:05,9,69.2,24,64.6,33,65.9,2,0
12/30/2017 2:10,9,69.3,24,64.7,33,66,2,0
12/30/2017 2:15,9,69.4,24,64.7,33,66,2,0
12/30/2017 2:20,8,69.3,23,64.7,31,65.9,2,0
12/30/2017 2:25,11,69.3,21,64.7,32,66.3,2,0
12/30/2017 2:30,7,69.3,22,64.7,29,65.8,2,0
12/30/2017 2:35,7,69.1,22,64.4,29,65.5,2,0
12/30/2017 2:40,7,69.2,22,64.6,29,65.7,2,0
12/30/2017 2:45,9,69.3,24,64.7,33,65.9,2,0
12/30/2017 2:50,9,69.3,25,64.7,34,65.9,2,0
12/30/2017 2:55,5,69.3,21,64.7,26,65.5,2,0
12/30/2017 3:00,6,69.3,22,64.7,28,65.7,2,0
12/30/2017 3:05,9,69.3,24,64.7,33,66,2,0
12/30/2017 3:10,11,69.4,27,64.8,38,66.1,2,0
12/30/2017 3:15,10,69.3,25,64.7,35,66,2,0
12/30/2017 3:20,10,69.3,25,64.7,35,66,2,0
12/30/2017 3:25,9,69.4,25,64.8,34,66,2,0
12/30/2017 3:30,9,69.4,25,64.8,34,66,2,0
12/30/2017 3:35,11,69.4,27,64.8,38,66.1,2,0
12/30/2017 3:40,12,69.4,26,64.8,38,66.3,2,0
12/30/2017 3:45,10,69.4,26,64.8,36,66.1,2,0
12/30/2017 3:50,12,69.3,27,64.7,39,66.2,2,0
12/30/2017 3:55,15,69.4,30,64.8,45,66.3,2,0
12/30/2017 4:00,8,69.2,23,64.6,31,65.8,2,0
12/30/2017 4:05,13,68.9,29,64.2,42,65.7,2,0
12/30/2017 4:10,13,69.2,28,64.5,41,66,2,0
12/30/2017 4:15,14,69.3,30,64.7,44,66.2,2,0
12/30/2017 4:20,13,69.3,28,64.7,41,66.2,2,0
12/30/2017 4:25,15,69.3,31,64.7,46,66.2,2,0
12/30/2017 4:30,12,69.3,27,64.7,39,66.1,2,0
12/30/2017 4:35,19,69.3,35,64.7,54,66.3,2,0
12/30/2017 4:40,12,69.4,27,64.8,39,66.2,2,0
12/30/2017 4:45,21,69.5,37,64.9,58,66.5,2,0
12/30/2017 4:50,17,69.5,33,64.9,50,66.5,2,0
12/30/2017 4:55,13,69.5,29,64.9,42,66.3,2,0
12/30/2017 5:00,11,69.2,26,64.5,37,65.9,2,0
12/30/2017 5:05,15,69.1,31,64.5,46,66,2,0
12/30/2017 5:10,18,69.6,34,65,52,66.6,2,0
12/30/2017 5:15,19,69.7,34,65.1,53,66.7,2,0
12/30/2017 5:20,18,69.6,34,65,52,66.6,2,0
12/30/2017 5:25,19,69.5,35,64.9,54,66.5,2,0
12/30/2017 5:30,16,69.6,32,65,48,66.5,2,0
12/30/2017 5:35,19,69.5,35,64.9,54,66.5,2,0
12/30/2017 5:40,20,69.6,36,65,56,66.7,2,0
12/30/2017 5:45,18,69.6,34,65,52,66.6,2,0
12/30/2017 5:50,14,69.6,30,65,44,66.4,2,0
12/30/2017 5:55,13,69.6,29,65,42,66.4,2,0
12/30/2017 6:00,15,69.1,31,64.5,46,66,2,0
12/30/2017 6:05,15,69.2,30,64.6,45,66.1,2,0
12/30/2017 6:10,16,69.2,32,64.6,48,66.1,2,0
12/30/2017 6:15,21,69.2,37,64.6,58,66.3,2,0
12/30/2017 6:20,19,69.4,35,64.8,54,66.4,2,0
12/30/2017 6:25,19,69.4,35,64.8,54,66.4,2,0
12/30/2017 6:30,12,69.2,27,64.6,39,66,2,0
12/30/2017 6:35,20,69.4,37,64.7,57,66.4,2,0
12/30/2017 6:40,17,69.3,33,64.7,50,66.3,2,0
12/30/2017 6:45,26,68.5,42,63.9,68,65.6,2,0
12/30/2017 6:50,16,69,32,64.3,48,65.9,2,0
12/30/2017 6:55,26,68.5,42,63.9,68,65.6,2,0
12/30/2017 7:00,21,68.8,37,64.1,58,65.8,2,0
12/30/2017 7:05,22,68.8,38,64.2,60,65.9,2,0
12/30/2017 7:10,21,68.5,37,63.9,58,65.6,2,0
12/30/2017 7:15,22,67.6,38,62.9,60,64.6,2,0
12/30/2017 7:20,22,68.3,38,63.7,60,65.4,2,0
12/30/2017 7:25,26,68.8,42,64.2,68,65.9,2,0
12/30/2017 7:30,25,69,41,64.3,66,66.1,2,0
12/30/2017 7:35,26,69.1,43,64.5,69,66.2,2,0
12/30/2017 7:40,23,69.3,40,64.7,63,66.4,2,0
12/30/2017 7:45,24,69.6,40,65,64,66.7,2,0
12/30/2017 7:50,27,69.8,44,65.2,71,67,2,0
12/30/2017 7:55,28,69.7,44,65.1,72,66.9,2,0
12/30/2017 8:00,22,69.4,39,64.8,61,66.5,2,0
12/30/2017 8:05,30,68.7,46,64.1,76,65.9,2,0
12/30/2017 8:10,31,69.2,48,64.6,79,66.4,2,0
12/30/2017 8:15,29,69.2,45,64.6,74,66.4,2,0
12/30/2017 8:20,33,68.9,50,64.3,83,66.1,2,0
12/30/2017 8:25,26,69.3,42,64.7,68,66.5,2,0
12/30/2017 8:30,36,69.4,52,64.8,88,66.7,2,0
12/30/2017 8:35,28,69.6,44,65,72,66.8,2,0
12/30/2017 8:40,37,69.8,53,65.3,90,67.1,2,0
12/30/2017 8:45,39,70.2,57,65.7,96,67.6,2,0
12/30/2017 8:50,40,70.9,57,66.5,97,68.3,2,0
12/30/2017 8:55,37,69.5,54,64.9,91,66.8,2,0
12/30/2017 9:00,34,69,51,64.4,85,66.2,2,0
12/30/2017 9:05,34,69.3,51,64.7,85,66.5,2,0
12/30/2017 9:10,41,69.1,58,64.5,99,66.4,2,0
12/30/2017 9:15,38,69,54,64.4,92,66.3,2,0
12/30/2017 9:20,42,68.8,60,64.1,102,66,2,0
12/30/2017 9:25,37,68.8,55,64.1,92,66,2,0
12/30/2017 9:30,38,68.5,55,63.8,93,65.7,2,0
12/30/2017 9:35,45,68.1,62,63.3,107,65.3,2,0
12/30/2017 9:40,40,68.5,57,63.8,97,65.7,2,0
12/30/2017 9:45,45,68.6,61,63.9,106,65.9,2,0
12/30/2017 9:50,42,68.2,60,63.5,102,65.4,2,0
12/30/2017 9:55,40,68.9,57,64.2,97,66.2,2,0
12/30/2017 10:00,45,68.7,63,64,108,66,2,0
12/30/2017 10:05,43,69.8,59,65.3,102,67.2,2,0
12/30/2017 10:10,48,70,65,65.4,113,67.4,2,0
12/30/2017 10:15,52,70.1,69,65.6,121,67.5,2,0
12/30/2017 10:20,44,69.5,62,65,106,66.9,2,0
12/30/2017 10:25,45,68.9,62,64.3,107,66.2,2,0
12/30/2017 10:30,55,68.9,73,64.3,128,66.3,2,0
12/30/2017 10:35,47,68.2,64,63.5,111,65.5,2,0
12/30/2017 10:40,47,67.5,65,62.8,112,64.8,2,0
12/30/2017 10:45,50,69.1,67,64.5,117,66.5,2,0
12/30/2017 10:50,48,68,65,63.3,113,65.3,2,0
12/30/2017 10:55,58,68.8,77,64.1,135,66.1,2,0
12/30/2017 11:00,44,69.3,61,64.6,105,66.6,2,0
12/30/2017 11:05,50,69.2,67,64.6,117,66.6,2,0
12/30/2017 11:10,53,69,71,64.4,124,66.3,2,0
12/30/2017 11:15,52,68.3,71,63.6,123,65.6,2,0
12/30/2017 11:20,52,67.5,71,62.7,123,64.7,2,0
12/30/2017 11:25,57,67.4,75,62.6,132,64.6,2,0
12/30/2017 11:30,50,67.3,68,62.5,118,64.5,2,0
12/30/2017 11:35,48,68.2,66,63.4,114,65.4,2,0
12/30/2017 11:40,40,69.2,57,64.5,97,66.4,2,0
12/30/2017 11:45,45,69.3,63,64.7,108,66.6,2,0
12/30/2017 11:50,55,68.6,73,63.9,128,65.9,2,0
12/30/2017 11:55,45,69,62,64.3,107,66.3,2,0
12/30/2017 12:00,46,69,64,64.4,110,66.3,2,0
12/30/2017 12:05,47,69.1,65,64.5,112,66.5,2,0
12/30/2017 12:10,53,69.7,70,65.2,123,67.1,2,0
12/30/2017 12:15,54,68.9,72,64.3,126,66.2,2,0
12/30/2017 12:20,47,69.5,64,64.9,111,66.9,2,0
12/30/2017 12:25,46,69.8,63,65.3,109,67.2,2,0
12/30/2017 12:30,56,69.8,74,65.2,130,67.2,2,0
12/30/2017 12:35,47,68.8,65,64.1,112,66.1,2,0
12/30/2017 12:40,52,69.1,69,64.5,121,66.5,2,0
12/30/2017 12:45,56,69.1,74,64.5,130,66.5,2,0
12/30/2017 12:50,59,69.4,78,64.8,137,66.8,2,0
12/30/2017 12:55,50,70.3,68,65.8,118,67.7,2,0
12/30/2017 13:00,58,69.2,76,64.7,134,66.7,2,0
12/30/2017 13:05,59,69,77,64.5,136,66.4,2,0
12/30/2017 13:10,53,69.4,71,64.8,124,66.8,2,0
12/30/2017 13:15,52,69.9,70,65.3,122,67.3,2,0
12/30/2017 13:20,49,69.4,66,64.9,115,66.8,2,0
12/30/2017 13:25,55,69.6,73,65,128,67,2,0
12/30/2017 13:30,61,68.5,79,63.9,140,65.9,2,0
12/30/2017 13:35,65,68.8,84,64.1,149,66.1,2,0
12/30/2017 13:40,63,68.6,81,64,144,66,2,0
12/30/2017 13:45,66,69.2,85,64.6,151,66.6,2,0
12/30/2017 13:50,56,69.5,74,64.9,130,66.9,2,0
12/30/2017 13:55,61,70.2,79,65.7,140,67.7,2,0
12/30/2017 14:00,50,69.7,67,65.1,117,67.1,2,0
12/30/2017 14:05,56,69.5,74,64.9,130,66.9,2,0
12/30/2017 14:10,66,70.1,84,65.6,150,67.5,2,0
12/30/2017 14:15,55,69.9,72,65.4,127,67.3,2,0
12/30/2017 14:20,50,70,68,65.5,118,67.4,2,0
12/30/2017 14:25,55,69.3,74,64.7,129,66.6,2,0
12/30/2017 14:30,64,69.8,83,65.2,147,67.2,2,0
12/30/2017 14:35,53,69.6,71,65,124,66.9,2,0
12/30/2017 14:40,64,68.6,83,64,147,66,2,0
12/30/2017 14:45,56,69.6,74,65,130,67,2,0
12/30/2017 14:50,59,69.6,77,65.1,136,67,2,0
12/30/2017 14:55,56,69.3,74,64.7,130,66.6,2,0
12/30/2017 15:00,50,68.8,68,64.1,118,66.1,2,0
12/30/2017 15:05,58,68.7,76,64,134,66,2,0
12/30/2017 15:10,58,68.8,77,64.1,135,66.1,2,0
12/30/2017 15:15,64,69.3,83,64.7,147,66.7,2,0
12/30/2017 15:20,60,69.5,79,65,139,67,2,0
12/30/2017 15:25,56,69.9,73,65.4,129,67.3,2,0
12/30/2017 15:30,64,69.6,83,65.1,147,67.1,2,0
12/30/2017 15:35,59,69.3,77,64.8,136,66.7,2,0
12/30/2017 15:40,73,69.3,92,64.7,165,66.8,2,0
12/30/2017 15:45,65,68.8,83,64.1,148,66.2,2,0
12/30/2017 15:50,62,68.6,81,63.9,143,66,2,0
12/30/2017 15:55,73,68.7,93,64.1,166,66.1,2,0
12/30/2017 16:00,71,69.3,89,64.8,160,66.8,2,0
12/30/2017 16:05,71,69.2,89,64.7,160,66.7,2,0
12/30/2017 16:10,62,69.3,82,64.7,144,66.7,2,0
12/30/2017 16:15,57,68.3,76,63.7,133,65.7,2,0
12/30/2017 16:20,55,68.3,74,63.7,129,65.6,2,0
12/30/2017 16:25,72,68,91,63.3,163,65.4,2,0
12/30/2017 16:30,68,67.7,87,63,155,65.1,2,0
12/30/2017 16:35,76,68,97,63.3,173,65.3,2,0
12/30/2017 16:40,57,68.3,76,63.6,133,65.6,2,0
12/30/2017 16:45,62,68.3,82,63.6,144,65.6,2,0
12/30/2017 16:50,64,68.4,83,63.7,147,65.8,2,0
12/30/2017 16:55,52,68.6,70,63.9,122,65.9,2,0
12/30/2017 17:00,52,69.2,70,64.6,122,66.6,2,0
12/30/2017 17:05,50,69.2,69,64.6,119,66.5,2,0
12/30/2017 17:10,56,69.9,74,65.4,130,67.3,2,0
12/30/2017 17:15,60,68.9,78,64.3,138,66.3,2,0
12/30/2017 17:20,59,69.5,77,65,136,67,2,0
12/30/2017 17:25,58,68.5,76,63.8,134,65.8,2,0
12/30/2017 17:30,50,68.6,68,63.9,118,65.9,2,0
12/30/2017 17:35,41,67.7,57,63,98,65,2,0
12/30/2017 17:40,46,67.8,63,63.1,109,65,2,0
12/30/2017 17:45,45,67.6,62,62.8,107,64.8,2,0
12/30/2017 17:50,50,67.5,68,62.8,118,64.8,2,0
12/30/2017 17:55,54,68,72,63.3,126,65.3,2,0
12/30/2017 18:00,51,68,68,63.2,119,65.3,2,0
12/30/2017 18:05,48,68.8,66,64.1,114,66,2,0
12/30/2017 18:10,54,68.7,71,64,125,66,2,0
12/30/2017 18:15,55,68.9,73,64.2,128,66.2,2,0
12/30/2017 18:20,53,69.2,69,64.5,122,66.5,2,0
12/30/2017 18:25,46,69.4,63,64.8,109,66.8,2,0
12/30/2017 18:30,44,69.9,61,65.3,105,67.2,2,0
12/30/2017 18:35,46,69.7,63,65.1,109,67,2,0
12/30/2017 18:40,50,70,67,65.4,117,67.4,2,0
12/30/2017 18:45,48,69.5,66,64.8,114,66.8,2,0
12/30/2017 18:50,42,69.7,60,65.2,102,67,2,0
12/30/2017 18:55,43,69.7,59,65.1,102,67,2,0
12/30/2017 19:00,45,69.8,62,65.3,107,67.2,2,0
12/30/2017 19:05,37,69.4,54,64.9,91,66.7,2,0
12/30/2017 19:10,33,69.5,49,65,82,66.8,2,0
12/30/2017 19:15,34,69.3,51,64.7,85,66.5,2,0
12/30/2017 19:20,36,68.7,53,64,89,65.9,2,0
12/30/2017 19:25,36,69,52,64.4,88,66.2,2,0
12/30/2017 19:30,30,69.2,47,64.6,77,66.4,2,0
12/30/2017 19:35,43,69,59,64.4,102,66.3,2,0
12/30/2017 19:40,27,69.3,44,64.7,71,66.5,2,0
12/30/2017 19:45,32,69.2,48,64.6,80,66.4,2,0
12/30/2017 19:50,37,68.9,53,64.3,90,66.2,2,0
12/30/2017 19:55,36,68.7,52,64.1,88,66,2,0
12/30/2017 20:00,26,68.9,43,64.3,69,66,2,0
12/30/2017 20:05,26,69.1,42,64.4,68,66.2,2,0
12/30/2017 20:10,24,69.2,40,64.6,64,66.3,2,0
12/30/2017 20:15,27,69.3,44,64.7,71,66.5,2,0
12/30/2017 20:20,19,69.4,35,64.8,54,66.4,2,0
12/30/2017 20:25,28,69.2,44,64.5,72,66.3,2,0
12/30/2017 20:30,26,69.2,42,64.6,68,66.3,2,0
12/30/2017 20:35,31,68.4,47,63.8,78,65.6,2,0
12/30/2017 20:40,20,68.8,36,64.2,56,65.9,2,0
12/30/2017 20:45,31,69.1,47,64.5,78,66.3,2,0
12/30/2017 20:50,26,69.3,42,64.7,68,66.5,2,0
12/30/2017 20:55,21,69.3,37,64.7,58,66.3,2,0
12/30/2017 21:00,28,68.9,43,64.2,71,66.1,2,0
12/30/2017 21:05,24,69,40,64.4,64,66.1,2,0
12/30/2017 21:10,23,68.3,39,63.7,62,65.4,2,0
12/30/2017 21:15,24,68.3,40,63.6,64,65.3,2,0
12/30/2017 21:20,26,68.9,41,64.3,67,66.1,2,0
12/30/2017 21:25,19,69.1,35,64.5,54,66.1,2,0
12/30/2017 21:30,26,69,42,64.4,68,66.1,2,0
12/30/2017 21:35,25,69.1,41,64.5,66,66.2,2,0
12/30/2017 21:40,23,69.5,39,64.9,62,66.6,2,0
12/30/2017 21:45,25,69.6,41,65,66,66.7,2,0
12/30/2017 21:50,15,69.5,31,64.9,46,66.4,2,0
12/30/2017 21:55,24,69.5,40,64.9,64,66.6,2,0
12/30/2017 22:00,24,69.3,40,64.7,64,66.4,2,0
12/30/2017 22:05,22,69.4,38,64.8,60,66.5,2,0
12/30/2017 22:10,25,69.5,40,64.9,65,66.6,2,0
12/30/2017 22:15,20,69.6,35,65,55,66.7,2,0
12/30/2017 22:20,23,69.7,39,65.1,62,66.8,2,0
12/30/2017 22:25,26,69.7,42,65.2,68,66.9,2,0
12/30/2017 22:30,15,69.4,30,64.8,45,66.4,2,0
12/30/2017 22:35,20,69.4,35,64.8,55,66.5,2,0
12/30/2017 22:40,20,69.3,36,64.7,56,66.3,2,0
12/30/2017 22:45,17,69.5,33,64.9,50,66.5,2,0
12/30/2017 22:50,16,69.4,31,64.8,47,66.4,2,0
12/30/2017 22:55,21,69.7,36,65.2,57,66.8,2,0
12/30/2017 23:00,20,69.6,37,65,57,66.6,2,0
12/30/2017 23:05,16,69.3,32,64.7,48,66.2,2,0
12/30/2017 23:10,20,69.4,36,64.8,56,66.4,2,0
12/30/2017 23:15,19,69.4,35,64.8,54,66.4,2,0
12/30/2017 23:20,18,69.3,33,64.7,51,66.3,2,0
12/30/2017 23:25,19,69.4,35,64.8,54,66.4,2,0
12/30/2017 23:30,16,69.4,31,64.8,47,66.4,2,0
12/30/2017 23:35,19,69.2,35,64.5,54,66.2,2,0
12/30/2017 23:40,11,69.3,26,64.7,37,66.1,2,0
12/30/2017 23:45,20,69.3,36,64.7,56,66.3,2,0
12/30/2017 23:50,16,69.3,32,64.7,48,66.2,2,0
12/30/2017 23:55,13,69.3,29,64.7,42,66.1,2,0
12/31/2017 0:00,12,69.3,27,64.7,39,66.2,2,0
12/31/2017 0:05,12,69.3,27,64.7,39,66.2,2,0
12/31/2017 0:10,10,69.4,25,64.8,35,66.1,2,0
12/31/2017 0:15,12,69.4,27,64.8,39,66.2,2,0
12/31/2017 0:20,14,69.3,29,64.7,43,66.2,2,0
12/31/2017 0:25,10,69.3,25,64.7,35,66,2,0
12/31/2017 0:30,11,69.3,26,64.7,37,66.1,2,0
12/31/2017 0:35,10,69.2,25,64.6,35,65.9,2,0
12/31/2017 0:40,8,69.3,23,64.7,31,65.9,2,0
12/31/2017 0:45,11,69.3,27,64.7,38,66,2,0
12/31/2017 0:50,11,69.3,26,64.7,37,66.1,2,0
12/31/2017 0:55,12,69.2,27,64.6,39,66,2,0
12/31/2017 1:00,6,69.3,22,64.7,28,65.6,2,0
12/31/2017 1:05,10,69.2,25,64.6,35,65.9,2,0
12/31/2017 1:10,10,69.2,26,64.5,36,65.8,2,0
12/31/2017 1:15,7,69.3,22,64.7,29,65.8,2,0
12/31/2017 1:20,11,69.3,26,64.7,37,66.1,2,0
12/31/2017 1:25,6,69.3,21,64.7,27,65.8,2,0
12/31/2017 1:30,9,69.4,24,64.8,33,66,2,0
12/31/2017 1:35,15,69.3,22,64.7,37,66.6,2,0
12/31/2017 1:40,8,69.3,23,64.7,31,65.9,2,0
12/31/2017 1:45,8,69.4,24,64.8,32,66,2,0
12/31/2017 1:50,9,69,24,64.4,33,65.7,2,0
12/31/2017 1:55,4,69.2,20,64.5,24,65.3,2,0
12/31/2017 2:00,10,69.3,20,64.7,30,66.2,2,0
12/31/2017 2:05,5,69.3,20,64.7,25,65.6,2,0
12/31/2017 2:10,9,69.3,24,64.7,33,66,2,0
12/31/2017 2:15,5,69.2,20,64.6,25,65.5,2,0
12/31/2017 2:20,10,69.3,26,64.7,36,66,2,0
12/31/2017 2:25,11,69.3,21,64.7,32,66.2,2,0
12/31/2017 2:30,8,69.3,24,64.7,32,65.8,2,0
12/31/2017 2:35,9,69.3,19,64.7,28,66.2,2,0
12/31/2017 2:40,8,69.3,23,64.7,31,65.8,2,0
12/31/2017 2:45,12,69.2,21,64.6,33,66.3,2,0
12/31/2017 2:50,11,69.3,21,64.7,32,66.3,2,0
12/31/2017 2:55,7,69.3,23,64.7,30,65.8,2,0
12/31/2017 3:00,5,69.3,20,64.7,25,65.6,2,0
12/31/2017 3:05,7,69.4,22,64.8,29,65.9,2,0
12/31/2017 3:10,7,69.3,22,64.7,29,65.8,2,0
12/31/2017 3:15,6,69.4,22,64.8,28,65.8,2,0
12/31/2017 3:20,8,69.4,19,64.8,27,66.1,2,0
12/31/2017 3:25,8,69.5,23,64.9,31,66.1,2,0
12/31/2017 3:30,9,69.4,24,64.8,33,66.1,2,0
12/31/2017 3:35,10,69.4,20,64.8,30,66.3,2,0
12/31/2017 3:40,7,69.4,23,64.8,30,65.9,2,0
12/31/2017 3:45,4,69.4,20,64.8,24,65.5,2,0
12/31/2017 3:50,5,69.4,21,64.8,26,65.7,2,0
12/31/2017 3:55,7,69.4,22,64.8,29,66,2,0
12/31/2017 4:00,6,69.4,21,64.8,27,65.8,2,0
12/31/2017 4:05,7,69.3,22,64.7,29,65.8,2,0
12/31/2017 4:10,7,69.3,22,64.7,29,65.8,2,0
12/31/2017 4:15,8,69.3,23,64.7,31,65.8,2,0
12/31/2017 4:20,7,69.3,22,64.7,29,65.8,2,0
12/31/2017 4:25,12,69.2,27,64.6,39,66,2,0
12/31/2017 4:30,7,69.4,22,64.8,29,65.9,2,0
12/31/2017 4:35,9,69.3,24,64.7,33,66,2,0
12/31/2017 4:40,13,69.1,28,64.5,41,65.9,2,0
12/31/2017 4:45,12,68.7,27,64.1,39,65.5,2,0
12/31/2017 4:50,9,69,24,64.4,33,65.7,2,0
12/31/2017 4:55,10,68.9,25,64.2,35,65.6,2,0
12/31/2017 5:00,12,69,28,64.4,40,65.7,2,0
12/31/2017 5:05,10,69.2,26,64.5,36,65.8,2,0
12/31/2017 5:10,13,68.7,29,64,42,65.4,2,0
12/31/2017 5:15,13,69,28,64.4,41,65.8,2,0
12/31/2017 5:20,13,69.2,28,64.6,41,66,2,0
12/31/2017 5:25,8,69.3,24,64.7,32,65.8,2,0
12/31/2017 5:30,12,69.3,27,64.7,39,66.1,2,0
12/31/2017 5:35,9,69.3,24,64.7,33,65.9,2,0
12/31/2017 5:40,12,69.2,27,64.6,39,66,2,0
12/31/2017 5:45,12,69.3,27,64.7,39,66.1,2,0
12/31/2017 5:50,10,69.2,26,64.6,36,65.9,2,0
12/31/2017 5:55,11,69.2,27,64.6,38,66,2,0
12/31/2017 6:00,10,69.2,25,64.6,35,65.9,2,0
12/31/2017 6:05,15,69.2,22,64.5,37,66.4,2,0
12/31/2017 6:10,11,69.1,26,64.5,37,65.9,2,0
12/31/2017 6:15,14,69.2,29,64.6,43,66.1,2,0
12/31/2017 6:20,9,69.3,25,64.7,34,65.9,2,0
12/31/2017 6:25,10,69.3,25,64.7,35,66.1,2,0
12/31/2017 6:30,13,69.3,29,64.7,42,66.1,2,0
12/31/2017 6:35,12,69.3,28,64.7,40,66,2,0
12/31/2017 6:40,14,69.2,30,64.5,44,66,2,0
12/31/2017 6:45,14,69.3,29,64.7,43,66.2,2,0
12/31/2017 6:50,15,69.4,30,64.8,45,66.3,2,0
12/31/2017 6:55,13,69.3,29,64.7,42,66.2,2,0
12/31/2017 7:00,16,69.3,32,64.7,48,66.2,2,0
12/31/2017 7:05,12,69.3,27,64.7,39,66.1,2,0
12/31/2017 7:10,20,69.2,35,64.5,55,66.2,2,0
12/31/2017 7:15,14,69.2,29,64.6,43,66.1,2,0
12/31/2017 7:20,18,69.3,33,64.7,51,66.3,2,0
12/31/2017 7:25,15,69.3,31,64.7,46,66.2,2,0
12/31/2017 7:30,18,69.4,34,64.8,52,66.4,2,0
12/31/2017 7:35,23,69.4,39,64.7,62,66.5,2,0
12/31/2017 7:40,20,69.4,36,64.8,56,66.5,2,0
12/31/2017 7:45,16,69.4,32,64.8,48,66.3,2,0
12/31/2017 7:50,16,69.4,31,64.8,47,66.3,2,0
12/31/2017 7:55,19,69.2,35,64.5,54,66.2,2,0
12/31/2017 8:00,23,69.4,39,64.8,62,66.5,2,0
12/31/2017 8:05,22,69.2,38,64.6,60,66.3,2,0
12/31/2017 8:10,13,69.3,28,64.7,41,66.1,2,0
12/31/2017 8:15,23,69.3,39,64.7,62,66.4,2,0
12/31/2017 8:20,29,69,45,64.4,74,66.2,2,0
12/31/2017 8:25,24,69.3,40,64.7,64,66.4,2,0
12/31/2017 8:30,17,69.3,34,64.7,51,66.2,2,0
12/31/2017 8:35,26,68.8,42,64.2,68,66,2,0
12/31/2017 8:40,27,69.3,43,64.7,70,66.4,2,0
12/31/2017 8:45,32,69.1,48,64.5,80,66.4,2,0
12/31/2017 8:50,25,69.1,42,64.5,67,66.2,2,0
12/31/2017 8:55,30,68.9,46,64.3,76,66.1,2,0
12/31/2017 9:00,30,69.3,46,64.7,76,66.5,2,0
12/31/2017 9:05,26,69.2,42,64.6,68,66.4,2,0
12/31/2017 9:10,29,69.4,45,64.8,74,66.6,2,0
12/31/2017 9:15,26,69.5,42,64.9,68,66.7,2,0
12/31/2017 9:20,33,69,50,64.3,83,66.2,2,0
12/31/2017 9:25,35,68.6,52,63.8,87,65.7,2,0
12/31/2017 9:30,30,68.9,46,64.2,76,66.1,2,0
12/31/2017 9:35,39,68.2,56,63.4,95,65.4,2,0
12/31/2017 9:40,31,69,47,64.3,78,66.1,2,0
12/31/2017 9:45,35,69.2,52,64.6,87,66.5,2,0
12/31/2017 9:50,39,69.6,56,65,95,66.8,2,0
12/31/2017 9:55,38,69.7,55,65.1,93,67,2,0
12/31/2017 10:00,46,69.8,64,65.2,110,67.1,2,0
12/31/2017 10:05,33,69.5,50,65,83,66.8,2,0
12/31/2017 10:10,34,69,51,64.4,85,66.2,2,0
12/31/2017 10:15,40,68.5,57,63.9,97,65.8,2,0
12/31/2017 10:20,37,68.9,54,64.3,91,66.2,2,0
12/31/2017 10:25,45,68.5,62,63.8,107,65.8,2,0
12/31/2017 10:30,35,69.2,52,64.6,87,66.5,2,0
12/31/2017 10:35,39,69.8,57,65.2,96,67.1,2,0
12/31/2017 10:40,37,69.3,54,64.7,91,66.6,2,0
12/31/2017 10:45,36,68.9,53,64.3,89,66.2,2,0
12/31/2017 10:50,45,68.9,63,64.3,108,66.2,2,0
12/31/2017 10:55,40,69.1,57,64.5,97,66.4,2,0
12/31/2017 11:00,39,69.5,55,65,94,66.9,2,0
12/31/2017 11:05,36,69.3,53,64.7,89,66.5,2,0
12/31/2017 11:10,48,68.8,65,64.2,113,66.1,2,0
12/31/2017 11:15,35,69,52,64.3,87,66.2,2,0
12/31/2017 11:20,38,69.2,56,64.6,94,66.5,2,0
12/31/2017 11:25,39,69.7,56,65.2,95,67,2,0
12/31/2017 11:30,36,69.3,53,64.7,89,66.6,2,0
12/31/2017 11:35,46,69.7,62,65.1,108,67.1,2,0
12/31/2017 11:40,38,69.7,54,65.1,92,67,2,0
12/31/2017 11:45,37,69.5,54,64.9,91,66.8,2,0
12/31/2017 11:50,45,69.6,62,65,107,67,2,0
12/31/2017 11:55,38,69.7,54,65.1,92,67,2,0
12/31/2017 12:00,44,69.4,61,64.8,105,66.7,2,0
12/31/2017 12:05,35,69.6,52,65,87,66.9,2,0
12/31/2017 12:10,41,69.4,57,64.8,98,66.7,2,0
12/31/2017 12:15,47,69,63,64.4,110,66.4,2,0
12/31/2017 12:20,43,69.3,60,64.7,103,66.6,2,0
12/31/2017 12:25,31,69.7,47,65.1,78,66.9,2,0
12/31/2017 12:30,38,70,54,65.5,92,67.3,2,0
12/31/2017 12:35,42,69.7,59,65.2,101,67.1,2,0
12/31/2017 12:40,36,69.7,53,65.2,89,67,2,0
12/31/2017 12:45,43,69.7,60,65.1,103,67.1,2,0
12/31/2017 12:50,39,69.1,56,64.5,95,66.4,2,0
12/31/2017 12:55,37,69.4,54,64.8,91,66.7,2,0
12/31/2017 13:00,43,69.4,60,64.8,103,66.7,2,0
12/31/2017 13:05,39,69,56,64.4,95,66.3,2,0
12/31/2017 13:10,36,69.8,53,65.2,89,67,2,0
12/31/2017 13:15,35,69.8,51,65.3,86,67.1,2,0
12/31/2017 13:20,29,69.8,45,65.3,74,67.1,2,0
12/31/2017 13:25,40,69.6,57,65,97,66.9,2,0
12/31/2017 13:30,44,69.7,60,65.1,104,67.1,2,0
12/31/2017 13:35,33,69.9,50,65.3,83,67.1,2,0
12/31/2017 13:40,32,69.7,48,65.1,80,66.9,2,0
12/31/2017 13:45,30,69.3,46,64.7,76,66.5,2,0
12/31/2017 13:50,33,69.3,50,64.7,83,66.5,2,0
12/31/2017 13:55,32,68.5,48,63.8,80,65.7,2,0
12/31/2017 14:00,33,68.9,50,64.3,83,66.2,2,0
12/31/2017 14:05,35,69.1,52,64.5,87,66.3,2,0
12/31/2017 14:10,34,69.8,51,65.2,85,67.1,2,0
12/31/2017 14:15,41,69.9,58,65.3,99,67.2,2,0
12/31/2017 14:20,37,69.9,53,65.3,90,67.2,2,0
12/31/2017 14:25,35,69.9,52,65.3,87,67.1,2,0
12/31/2017 14:30,38,70.1,54,65.6,92,67.5,2,0
12/31/2017 14:35,39,69.7,55,65.1,94,67,2,0
12/31/2017 14:40,42,69.6,59,65,101,66.9,2,0
12/31/2017 14:45,38,69.8,55,65.3,93,67.1,2,0
12/31/2017 14:50,42,69.9,59,65.4,101,67.3,2,0
12/31/2017 14:55,34,69.6,50,65.1,84,66.9,2,0
12/31/2017 15:00,35,68.8,51,64.2,86,66,2,0
12/31/2017 15:05,39,68.9,55,64.3,94,66.2,2,0
12/31/2017 15:10,29,69.2,45,64.6,74,66.4,2,0
12/31/2017 15:15,40,69.5,57,64.9,97,66.8,2,0
12/31/2017 15:20,33,69,49,64.4,82,66.3,2,0
12/31/2017 15:25,41,69,58,64.4,99,66.3,2,0
12/31/2017 15:30,47,69.4,63,64.8,110,66.8,2,0
12/31/2017 15:35,38,69.3,54,64.7,92,66.6,2,0
12/31/2017 15:40,37,69.3,53,64.7,90,66.5,2,0
12/31/2017 15:45,42,69,59,64.4,101,66.3,2,0
12/31/2017 15:50,41,69.5,59,65,100,66.8,2,0
12/31/2017 15:55,40,69.5,57,64.9,97,66.8,2,0
12/31/2017 16:00,37,69.7,54,65.1,91,67,2,0
12/31/2017 16:05,45,69.8,62,65.3,107,67.2,2,0
12/31/2017 16:10,49,70.1,66,65.7,115,67.6,2,0
12/31/2017 16:15,34,69.5,52,64.9,86,66.7,2,0
12/31/2017 16:20,33,69.5,49,64.9,82,66.8,2,0
12/31/2017 16:25,42,69.4,59,64.8,101,66.8,2,0
12/31/2017 16:30,41,69.3,57,64.7,98,66.7,2,0
12/31/2017 16:35,38,69.5,54,64.9,92,66.8,2,0
12/31/2017 16:40,38,69.8,54,65.2,92,67.1,2,0
12/31/2017 16:45,39,69.6,55,65,94,66.9,2,0
12/31/2017 16:50,47,69.5,65,64.9,112,66.8,2,0
12/31/2017 16:55,38,69.7,55,65.2,93,67,2,0
12/31/2017 17:00,34,69.4,51,64.8,85,66.6,2,0
12/31/2017 17:05,40,69.8,57,65.3,97,67.2,2,0
12/31/2017 17:10,41,69.6,58,65,99,66.9,2,0
12/31/2017 17:15,40,69.9,57,65.3,97,67.2,2,0
12/31/2017 17:20,39,69.1,56,64.5,95,66.4,2,0
12/31/2017 17:25,41,68.9,57,64.3,98,66.2,2,0
12/31/2017 17:30,43,68.3,60,63.6,103,65.6,2,0
12/31/2017 17:35,47,69.2,64,64.6,111,66.6,2,0
12/31/2017 17:40,41,68.7,58,64,99,66,2,0
12/31/2017 17:45,32,68.9,49,64.3,81,66.1,2,0
12/31/2017 17:50,31,69.2,47,64.6,78,66.4,2,0
12/31/2017 17:55,34,69.1,50,64.5,84,66.4,2,0
12/31/2017 18:00,33,69,49,64.4,82,66.2,2,0
12/31/2017 18:05,30,69.2,46,64.6,76,66.4,2,0
12/31/2017 18:10,35,68.9,52,64.3,87,66.2,2,0
12/31/2017 18:15,34,69.2,51,64.6,85,66.5,2,0
12/31/2017 18:20,34,69.3,51,64.7,85,66.5,2,0
12/31/2017 18:25,37,69,53,64.4,90,66.3,2,0
12/31/2017 18:30,30,68.8,46,64.2,76,66,2,0
12/31/2017 18:35,35,69.1,51,64.4,86,66.3,2,0
12/31/2017 18:40,29,68.9,45,64.2,74,66.1,2,0
12/31/2017 18:45,35,68.9,51,64.3,86,66.2,2,0
12/31/2017 18:50,40,68.8,58,64.2,98,66.1,2,0
12/31/2017 18:55,35,69.2,52,64.6,87,66.5,2,0
12/31/2017 19:00,38,69,55,64.4,93,66.3,2,0
12/31/2017 19:05,34,69.2,50,64.6,84,66.5,2,0
12/31/2017 19:10,32,68.9,48,64.3,80,66.1,2,0
12/31/2017 19:15,35,69.7,51,65.1,86,67,2,0
12/31/2017 19:20,36,69.1,52,64.5,88,66.4,2,0
12/31/2017 19:25,28,69.1,45,64.5,73,66.3,2,0
12/31/2017 19:30,26,69,43,64.4,69,66.2,2,0
12/31/2017 19:35,28,69.8,44,65.2,72,67,2,0
12/31/2017 19:40,30,69.6,46,65.1,76,66.9,2,0
12/31/2017 19:45,26,69.4,43,64.7,69,66.5,2,0
12/31/2017 19:50,27,69.2,42,64.6,69,66.4,2,0
12/31/2017 19:55,21,69.3,37,64.7,58,66.4,2,0
12/31/2017 20:00,25,69.7,40,65.1,65,66.8,2,0
12/31/2017 20:05,25,69.5,40,64.9,65,66.7,2,0
12/31/2017 20:10,27,69.4,42,64.8,69,66.6,2,0
12/31/2017 20:15,21,69.5,37,64.9,58,66.6,2,0
12/31/2017 20:20,23,69.6,38,65,61,66.7,2,0
12/31/2017 20:25,22,69.5,37,64.9,59,66.6,2,0
12/31/2017 20:30,26,69.7,42,65.2,68,66.9,2,0
12/31/2017 20:35,21,69.7,36,65.2,57,66.8,2,0
12/31/2017 20:40,22,69.7,38,65.1,60,66.8,2,0
12/31/2017 20:45,22,69.5,38,64.9,60,66.6,2,0
12/31/2017 20:50,20,69.5,35,64.9,55,66.6,2,0
12/31/2017 20:55,24,69.6,39,65,63,66.8,2,0
12/31/2017 21:00,21,69.5,36,64.9,57,66.6,2,0
12/31/2017 21:05,23,69.1,38,64.5,61,66.2,2,0
12/31/2017 21:10,23,68.8,39,64.2,62,65.9,2,0
12/31/2017 21:15,22,69.1,38,64.5,60,66.2,2,0
12/31/2017 21:20,23,69.3,38,64.7,61,66.4,2,0
12/31/2017 21:25,22,69.4,38,64.8,60,66.5,2,0
12/31/2017 21:30,23,69,38,64.4,61,66.2,2,0
12/31/2017 21:35,25,69.3,41,64.7,66,66.5,2,0
12/31/2017 21:40,17,69.4,33,64.7,50,66.3,2,0
12/31/2017 21:45,25,69.4,40,64.8,65,66.6,2,0
12/31/2017 21:50,22,69.5,37,64.9,59,66.6,2,0
12/31/2017 21:55,16,69.4,31,64.8,47,66.4,2,0
12/31/2017 22:00,22,69.4,37,64.8,59,66.5,2,0
12/31/2017 22:05,15,69.2,30,64.6,45,66.2,2,0
12/31/2017 22:10,19,69.3,35,64.7,54,66.3,2,0
12/31/2017 22:15,18,69.2,34,64.6,52,66.2,2,0
12/31/2017 22:20,21,69.4,37,64.7,58,66.4,2,0
12/31/2017 22:25,20,69.1,35,64.4,55,66.1,2,0
12/31/2017 22:30,18,69.3,34,64.7,52,66.3,2,0
12/31/2017 22:35,16,69.3,31,64.7,47,66.3,2,0
12/31/2017 22:40,19,69.1,35,64.5,54,66.1,2,0
12/31/2017 22:45,16,69.2,32,64.6,48,66.2,2,0
12/31/2017 22:50,14,69.3,30,64.7,44,66.2,2,0
12/31/2017 22:55,17,69.4,33,64.8,50,66.3,2,0
12/31/2017 23:00,14,69.5,30,64.9,44,66.3,2,0
12/31/2017 23:05,17,69.5,33,64.9,50,66.5,2,0
12/31/2017 23:10,14,69.5,29,64.9,43,66.4,2,0
12/31/2017 23:15,15,69.4,30,64.8,45,66.3,2,0
12/31/2017 23:20,16,69.3,31,64.7,47,66.3,2,0
12/31/2017 23:25,15,69.3,31,64.7,46,66.2,2,0
12/31/2017 23:30,17,69.3,32,64.7,49,66.3,2,0
12/31/2017 23:35,17,69.3,32,64.7,49,66.3,2,0
12/31/2017 23:40,12,69.3,27,64.7,39,66.1,2,0
12/31/2017 23:45,12,69.5,27,64.9,39,66.3,2,0
12/31/2017 23:50,9,69.4,24,64.8,33,66.1,2,0
12/31/2017 23:55,9,69.4,25,64.8,34,66,2,0
