5 Minutes,Lane 1 Flow (Veh/5 Minutes),Lane 1 Speed (mph),Lane 2 Flow (Veh/5 Minutes),Lane 2 Speed (mph),Flow (Veh/5 Minutes),Speed (mph),# Lane Points,% Observed
12/04/2017 0:00,11,69.3,27,64.7,38,66.1,2,0
12/04/2017 0:05,12,69.3,28,64.7,40,66.1,2,0
12/04/2017 0:10,13,69.3,28,64.7,41,66.2,2,0
12/04/2017 0:15,7,69.3,22,64.7,29,65.8,2,0
12/04/2017 0:20,11,69.3,27,64.7,38,66.1,2,0
12/04/2017 0:25,9,69.3,24,64.7,33,66,2,0
12/04/2017 0:30,9,69.3,24,64.7,33,65.9,2,0
12/04/2017 0:35,8,69.2,23,64.6,31,65.8,2,0
12/04/2017 0:40,10,69,25,64.4,35,65.7,2,0
12/04/2017 0:45,7,69.2,22,64.5,29,65.7,2,0
12/04/2017 0:50,8,69.2,23,64.5,31,65.7,2,0
12/04/2017 0:55,14,69.2,22,64.6,36,66.4,2,0
12/04/2017 1:00,7,69.3,23,64.7,30,65.8,2,0
12/04/2017 1:05,6,69.3,21,64.7,27,65.8,2,0
12/04/2017 1:10,10,69.3,20,64.7,30,66.3,2,0
12/04/2017 1:15,8,69.4,23,64.8,31,66,2,0
12/04/2017 1:20,8,69.4,24,64.8,32,66,2,0
12/04/2017 1:25,7,69.4,22,64.8,29,66,2,0
12/04/2017 1:30,9,69.5,24,64.9,33,66.1,2,0
12/04/2017 1:35,7,69.4,23,64.8,30,65.9,2,0
12/04/2017 1:40,7,69.4,22,64.8,29,65.9,2,0
12/04/2017 1:45,11,69.4,21,64.8,32,66.4,2,0
12/04/2017 1:50,6,69.5,21,64.9,27,65.9,2,0
12/04/2017 1:55,8,69.3,24,64.7,32,65.9,2,0
12/04/2017 2:00,13,69.4,21,64.8,34,66.5,2,0
12/04/2017 2:05,7,69.3,22,64.7,29,65.8,2,0
12/04/2017 2:10,6,69.2,21,64.6,27,65.6,2,0
12/04/2017 2:15,5,69.2,20,64.6,25,65.5,2,0
12/04/2017 2:20,7,69.2,22,64.6,29,65.7,2,0
12/04/2017 2:25,8,69.2,23,64.5,31,65.7,2,0
12/04/2017 2:30,7,69,23,64.3,30,65.4,2,0
12/04/2017 2:35,7,69.2,22,64.6,29,65.7,2,0
12/04/2017 2:40,10,69.3,25,64.7,35,66,2,0
12/04/2017 2:45,10,69.1,25,64.5,35,65.8,2,0
12/04/2017 2:50,9,69.3,24,64.7,33,66,2,0
12/04/2017 2:55,7,69.1,23,64.5,30,65.6,2,0
12/04/2017 3:00,8,69.3,24,64.7,32,65.8,2,0
12/04/2017 3:05,11,69,27,64.4,38,65.7,2,0
12/04/2017 3:10,7,69.2,22,64.6,29,65.7,2,0
12/04/2017 3:15,8,69.2,24,64.6,32,65.8,2,0
12/04/2017 3:20,12,69.3,28,64.7,40,66.1,2,0
12/04/2017 3:25,10,69.1,25,64.5,35,65.8,2,0
12/04/2017 3:30,10,69.3,25,64.7,35,66,2,0
12/04/2017 3:35,10,69.4,25,64.8,35,66.1,2,0
12/04/2017 3:40,14,69.4,29,64.8,43,66.3,2,0
12/04/2017 3:45,16,69.4,32,64.8,48,66.3,2,0
12/04/2017 3:50,16,69.5,32,64.9,48,66.4,2,0
12/04/2017 3:55,16,69.3,32,64.7,48,66.2,2,0
12/04/2017 4:00,17,69.4,34,64.8,51,66.3,2,0
12/04/2017 4:05,16,69.4,32,64.7,48,66.3,2,0
12/04/2017 4:10,18,69.2,34,64.6,52,66.2,2,0
12/04/2017 4:15,25,67.9,41,63.1,66,64.9,2,0
12/04/2017 4:20,24,68,40,63.3,64,65.1,2,0
12/04/2017 4:25,25,68.8,42,64.1,67,65.8,2,0
12/04/2017 4:30,31,69.4,47,64.8,78,66.6,2,0
12/04/2017 4:35,25,69.7,42,65.1,67,66.8,2,0
12/04/2017 4:40,37,70.1,54,65.5,91,67.4,2,0
12/04/2017 4:45,43,71.2,62,66.7,105,68.6,2,0
12/04/2017 4:50,38,70.8,56,66.3,94,68.1,2,0
12/04/2017 4:55,40,69.9,59,65.3,99,67.2,2,0
12/04/2017 5:00,52,70.6,71,66.2,123,68.1,2,0
12/04/2017 5:05,51,70.8,71,66.3,122,68.2,2,0
12/04/2017 5:10,49,70.6,67,66.1,116,68,2,0
12/04/2017 5:15,55,70.8,76,66.3,131,68.2,2,0
12/04/2017 5:20,63,70.6,83,66.1,146,68,2,0
12/04/2017 5:25,58,68.8,79,64.2,137,66.1,2,0
12/04/2017 5:30,61,69.8,81,65.2,142,67.1,2,0
12/04/2017 5:35,62,68.6,82,63.9,144,65.9,2,0
12/04/2017 5:40,65,69.2,86,64.5,151,66.5,2,0
12/04/2017 5:45,71,69,93,64.4,164,66.4,2,0
12/04/2017 5:50,65,68.3,86,63.5,151,65.5,2,0
12/04/2017 5:55,62,68.1,83,63.4,145,65.4,2,0
12/04/2017 6:00,54,68,74,63.2,128,65.2,2,0
12/04/2017 6:05,59,67.7,79,62.8,138,64.9,2,0
12/04/2017 6:10,63,68.1,85,63.4,148,65.4,2,0
12/04/2017 6:15,60,66.9,81,62,141,64.1,2,0
12/04/2017 6:20,69,66.2,91,61.3,160,63.4,2,0
12/04/2017 6:25,59,66.8,80,61.9,139,64,2,0
12/04/2017 6:30,73,66.6,96,61.7,169,63.9,2,0
12/04/2017 6:35,72,67.1,94,62.2,166,64.3,2,0
12/04/2017 6:40,76,66.6,99,61.7,175,63.8,2,0
12/04/2017 6:45,78,67.1,100,62.2,178,64.4,2,0
12/04/2017 6:50,74,66.4,96,61.5,170,63.7,2,0
12/04/2017 6:55,74,67.8,95,63,169,65.1,2,0
12/04/2017 7:00,64,67.8,86,63,150,65,2,0
12/04/2017 7:05,79,67.6,101,62.8,180,64.9,2,0
12/04/2017 7:10,74,67.1,98,62.2,172,64.3,2,0
12/04/2017 7:15,82,67.5,105,62.6,187,64.7,2,0
12/04/2017 7:20,89,67.7,114,62.9,203,65,2,0
12/04/2017 7:25,79,66.8,101,61.9,180,64.1,2,0
12/04/2017 7:30,84,68.2,108,63.4,192,65.5,2,0
12/04/2017 7:35,80,68,103,63.2,183,65.3,2,0
12/04/2017 7:40,91,67.2,116,62.3,207,64.5,2,0
12/04/2017 7:45,84,67.1,108,62.2,192,64.4,2,0
12/04/2017 7:50,80,66.1,102,61.1,182,63.3,2,0
12/04/2017 7:55,77,67.1,99,62.2,176,64.3,2,0
12/04/2017 8:00,70,67.6,93,62.8,163,64.9,2,0
12/04/2017 8:05,81,67,104,62.1,185,64.3,2,0
12/04/2017 8:10,78,68.1,100,63.2,178,65.3,2,0
12/04/2017 8:15,69,68.1,90,63.2,159,65.3,2,0
12/04/2017 8:20,72,67.4,95,62.6,167,64.7,2,0
12/04/2017 8:25,77,66.3,99,61.4,176,63.6,2,0
12/04/2017 8:30,74,64.5,96,59.4,170,61.6,2,0
12/04/2017 8:35,81,65.1,105,60.1,186,62.3,2,0
12/04/2017 8:40,82,65,105,60,187,62.2,2,0
12/04/2017 8:45,92,64.6,115,59.5,207,61.8,2,0
12/04/2017 8:50,85,65.3,108,60.3,193,62.5,2,0
12/04/2017 8:55,87,64.9,109,59.8,196,62.1,2,0
12/04/2017 9:00,73,64.9,94,59.8,167,62.1,2,0
12/04/2017 9:05,72,67.2,93,62.4,165,64.5,2,0
12/04/2017 9:10,68,67.9,89,63.1,157,65.1,2,0
12/04/2017 9:15,73,68.1,95,63.4,168,65.4,2,0
12/04/2017 9:20,70,69.1,89,64.3,159,66.4,2,0
12/04/2017 9:25,58,68.5,78,63.8,136,65.8,2,0
12/04/2017 9:30,63,69.5,82,64.9,145,66.9,2,0
12/04/2017 9:35,65,68.4,85,63.7,150,65.8,2,0
12/04/2017 9:40,61,69.1,80,64.4,141,66.5,2,0
12/04/2017 9:45,52,69.1,71,64.4,123,66.4,2,0
12/04/2017 9:50,53,68.1,72,63.4,125,65.4,2,0
12/04/2017 9:55,61,66.4,83,61.5,144,63.6,2,0
12/04/2017 10:00,78,60.6,101,55.1,179,57.5,2,0
12/04/2017 10:05,63,61.3,82,55.9,145,58.2,2,0
12/04/2017 10:10,58,62.9,77,57.7,135,59.9,2,0
12/04/2017 10:15,53,64.1,71,59,124,61.2,2,0
12/04/2017 10:20,42,66.1,60,61.3,102,63.3,2,0
12/04/2017 10:25,52,67.3,70,62.6,122,64.6,2,0
12/04/2017 10:30,50,67.1,68,62.3,118,64.3,2,0
12/04/2017 10:35,46,68.8,64,64.2,110,66.1,2,0
12/04/2017 10:40,49,67.7,67,62.9,116,64.9,2,0
12/04/2017 10:45,54,68,72,63.3,126,65.3,2,0
12/04/2017 10:50,50,67.5,69,62.7,119,64.7,2,0
12/04/2017 10:55,51,66.9,70,62.1,121,64.1,2,0
12/04/2017 11:00,54,67.2,71,62.4,125,64.5,2,0
12/04/2017 11:05,51,67.5,68,62.7,119,64.7,2,0
12/04/2017 11:10,47,68.9,66,64.3,113,66.2,2,0
12/04/2017 11:15,52,68.8,70,64.2,122,66.2,2,0
12/04/2017 11:20,53,68.7,71,64.1,124,66.1,2,0
12/04/2017 11:25,55,67.6,74,63,129,65,2,0
12/04/2017 11:30,54,68.1,72,63.5,126,65.5,2,0
12/04/2017 11:35,60,69.8,80,65.3,140,67.2,2,0
12/04/2017 11:40,40,69.8,57,65.4,97,67.2,2,0
12/04/2017 11:45,38,69.5,56,65,94,66.8,2,0
12/04/2017 11:50,65,68.7,85,64.1,150,66.1,2,0
12/04/2017 11:55,55,68.4,73,63.8,128,65.8,2,0
12/04/2017 12:00,51,69.6,69,65,120,67,2,0
12/04/2017 12:05,54,69,72,64.3,126,66.3,2,0
12/04/2017 12:10,44,67.5,62,62.7,106,64.7,2,0
12/04/2017 12:15,47,67.7,64,63,111,65,2,0
12/04/2017 12:20,62,67.3,81,62.6,143,64.6,2,0
12/04/2017 12:25,62,67.3,81,62.6,143,64.6,2,0
12/04/2017 12:30,42,66,58,61,100,63.1,2,0
12/04/2017 12:35,41,67.6,58,62.8,99,64.8,2,0
12/04/2017 12:40,58,68.6,78,63.8,136,65.9,2,0
12/04/2017 12:45,56,69.6,75,64.9,131,66.9,2,0
12/04/2017 12:50,51,68.9,69,64.2,120,66.2,2,0
12/04/2017 12:55,53,69.1,71,64.5,124,66.5,2,0
12/04/2017 13:00,39,68.7,56,64.1,95,66,2,0
12/04/2017 13:05,51,70.1,69,65.5,120,67.5,2,0
12/04/2017 13:10,48,70.5,66,65.9,114,67.8,2,0
12/04/2017 13:15,46,69.7,63,65.1,109,67,2,0
12/04/2017 13:20,48,68.1,65,63.4,113,65.4,2,0
12/04/2017 13:25,45,67.6,62,62.8,107,64.8,2,0
12/04/2017 13:30,53,68.2,71,63.6,124,65.6,2,0
12/04/2017 13:35,43,67.5,60,62.8,103,64.8,2,0
12/04/2017 13:40,52,69,69,64.4,121,66.4,2,0
12/04/2017 13:45,50,69.9,68,65.4,118,67.3,2,0
12/04/2017 13:50,55,69.6,74,65.1,129,67,2,0
12/04/2017 13:55,49,69.2,67,64.7,116,66.6,2,0
12/04/2017 14:00,45,70.2,62,65.8,107,67.7,2,0
12/04/2017 14:05,49,69.1,66,64.4,115,66.4,2,0
12/04/2017 14:10,58,67.8,76,63,134,65.1,2,0
12/04/2017 14:15,47,67.6,65,62.8,112,64.9,2,0
12/04/2017 14:20,43,66.2,61,61.3,104,63.4,2,0
12/04/2017 14:25,56,66.4,75,61.6,131,63.7,2,0
12/04/2017 14:30,43,68.9,60,64.3,103,66.2,2,0
12/04/2017 14:35,36,68.5,53,63.8,89,65.7,2,0
12/04/2017 14:40,46,69.1,64,64.5,110,66.4,2,0
12/04/2017 14:45,45,69.6,62,65,107,67,2,0
12/04/2017 14:50,43,69.8,60,65.2,103,67.2,2,0
12/04/2017 14:55,38,68,55,63.3,93,65.2,2,0
12/04/2017 15:00,46,68.5,63,63.8,109,65.8,2,0
12/04/2017 15:05,45,69.3,62,64.7,107,66.7,2,0
12/04/2017 15:10,47,69.5,65,64.9,112,66.8,2,0
12/04/2017 15:15,54,69.8,72,65.3,126,67.2,2,0
12/04/2017 15:20,60,69.9,78,65.3,138,67.3,2,0
12/04/2017 15:25,44,69.8,63,65.3,107,67.1,2,0
12/04/2017 15:30,62,67.8,82,63.1,144,65.2,2,0
12/04/2017 15:35,52,69.2,70,64.6,122,66.6,2,0
12/04/2017 15:40,58,69.4,77,64.8,135,66.7,2,0
12/04/2017 15:45,59,70,77,65.5,136,67.5,2,0
12/04/2017 15:50,61,70.8,78,66.4,139,68.3,2,0
12/04/2017 15:55,53,70.1,71,65.5,124,67.5,2,0
12/04/2017 16:00,48,70,65,65.5,113,67.4,2,0
12/04/2017 16:05,53,69.2,71,64.6,124,66.6,2,0
12/04/2017 16:10,54,69.5,72,65,126,66.9,2,0
12/04/2017 16:15,53,68.5,70,63.8,123,65.8,2,0
12/04/2017 16:20,51,68.6,69,63.9,120,65.9,2,0
12/04/2017 16:25,48,68.7,66,64,114,66,2,0
12/04/2017 16:30,53,68.4,71,63.7,124,65.7,2,0
12/04/2017 16:35,51,68.4,69,63.7,120,65.7,2,0
12/04/2017 16:40,57,68.6,75,63.9,132,66,2,0
12/04/2017 16:45,53,68.2,70,63.5,123,65.5,2,0
12/04/2017 16:50,60,67.6,79,62.9,139,64.9,2,0
12/04/2017 16:55,50,68.1,68,63.3,118,65.3,2,0
12/04/2017 17:00,57,69.1,75,64.5,132,66.5,2,0
12/04/2017 17:05,52,69.2,69,64.6,121,66.6,2,0
12/04/2017 17:10,57,69.6,76,65.1,133,67,2,0
12/04/2017 17:15,49,69.8,67,65.3,116,67.2,2,0
12/04/2017 17:20,53,68.5,70,63.9,123,65.9,2,0
12/04/2017 17:25,48,68.6,66,64,114,65.9,2,0
12/04/2017 17:30,50,67.7,68,63,118,65,2,0
12/04/2017 17:35,44,66,61,61,105,63.1,2,0
12/04/2017 17:40,51,66,69,61,120,63.1,2,0
12/04/2017 17:45,42,66.8,58,61.9,100,64,2,0
12/04/2017 17:50,49,66.9,66,62.1,115,64.1,2,0
12/04/2017 17:55,47,66.7,65,61.9,112,63.9,2,0
12/04/2017 18:00,47,67,65,62.3,112,64.3,2,0
12/04/2017 18:05,42,67.3,59,62.5,101,64.5,2,0
12/04/2017 18:10,48,69.2,66,64.7,114,66.6,2,0
12/04/2017 18:15,48,68.7,66,64.1,114,66.1,2,0
12/04/2017 18:20,48,70.3,65,65.8,113,67.7,2,0
12/04/2017 18:25,41,70.6,58,66.1,99,68,2,0
12/04/2017 18:30,47,70.4,64,65.9,111,67.8,2,0
12/04/2017 18:35,44,70.1,63,65.6,107,67.4,2,0
12/04/2017 18:40,42,69.3,58,64.7,100,66.7,2,0
12/04/2017 18:45,39,70.3,56,65.8,95,67.6,2,0
12/04/2017 18:50,32,69.7,49,65.1,81,66.9,2,0
12/04/2017 18:55,37,69.9,54,65.4,91,67.2,2,0
12/04/2017 19:00,36,70,53,65.4,89,67.3,2,0
12/04/2017 19:05,31,69.4,48,64.8,79,66.6,2,0
12/04/2017 19:10,31,68.8,48,64.1,79,66,2,0
12/04/2017 19:15,36,66.8,52,61.9,88,63.9,2,0
12/04/2017 19:20,31,67.6,48,62.8,79,64.7,2,0
12/04/2017 19:25,30,67.1,47,62.3,77,64.1,2,0
12/04/2017 19:30,37,67.4,54,62.6,91,64.6,2,0
12/04/2017 19:35,35,68.4,51,63.7,86,65.6,2,0
12/04/2017 19:40,33,69.4,49,64.8,82,66.7,2,0
12/04/2017 19:45,26,69.7,42,65.2,68,66.9,2,0
12/04/2017 19:50,32,69.9,50,65.4,82,67.2,2,0
12/04/2017 19:55,27,70.1,43,65.6,70,67.3,2,0
12/04/2017 20:00,27,70.2,43,65.7,70,67.4,2,0
12/04/2017 20:05,33,69.8,49,65.2,82,67,2,0
12/04/2017 20:10,29,69.2,46,64.5,75,66.3,2,0
12/04/2017 20:15,26,69.1,42,64.5,68,66.3,2,0
12/04/2017 20:20,29,69.2,44,64.6,73,66.4,2,0
12/04/2017 20:25,28,69.5,43,64.9,71,66.7,2,0
12/04/2017 20:30,25,68.6,40,64,65,65.8,2,0
12/04/2017 20:35,30,68.5,46,63.8,76,65.6,2,0
12/04/2017 20:40,26,69.4,42,64.8,68,66.6,2,0
12/04/2017 20:45,31,69.6,47,65,78,66.8,2,0
12/04/2017 20:50,26,69,42,64.4,68,66.2,2,0
12/04/2017 20:55,28,68.7,45,64,73,65.8,2,0
12/04/2017 21:00,21,69,37,64.4,58,66,2,0
12/04/2017 21:05,22,69.1,38,64.4,60,66.1,2,0
12/04/2017 21:10,25,69.3,42,64.7,67,66.4,2,0
12/04/2017 21:15,23,69,39,64.4,62,66.1,2,0
12/04/2017 21:20,27,69.5,43,64.9,70,66.7,2,0
12/04/2017 21:25,20,69.4,36,64.8,56,66.4,2,0
12/04/2017 21:30,24,69.3,40,64.7,64,66.4,2,0
12/04/2017 21:35,24,69.2,39,64.6,63,66.3,2,0
12/04/2017 21:40,22,69.3,38,64.6,60,66.3,2,0
12/04/2017 21:45,23,69.4,38,64.7,61,66.5,2,0
12/04/2017 21:50,22,69.6,37,65,59,66.7,2,0
12/04/2017 21:55,18,69.3,33,64.7,51,66.4,2,0
12/04/2017 22:00,22,69.4,38,64.8,60,66.5,2,0
12/04/2017 22:05,17,69.5,32,64.9,49,66.5,2,0
12/04/2017 22:10,17,69.5,33,64.9,50,66.5,2,0
12/04/2017 22:15,19,69.4,35,64.8,54,66.4,2,0
12/04/2017 22:20,14,69.1,30,64.5,44,66,2,0
12/04/2017 22:25,17,69.3,32,64.7,49,66.3,2,0
12/04/2017 22:30,19,69.4,34,64.8,53,66.4,2,0
12/04/2017 22:35,18,69.4,33,64.8,51,66.4,2,0
12/04/2017 22:40,16,69.1,31,64.4,47,66,2,0
12/04/2017 22:45,17,69.3,32,64.7,49,66.3,2,0
12/04/2017 22:50,17,69.4,33,64.8,50,66.4,2,0
12/04/2017 22:55,14,69.4,30,64.8,44,66.3,2,0
12/04/2017 23:00,17,69.4,33,64.8,50,66.3,2,0
12/04/2017 23:05,16,68.5,31,63.8,47,65.4,2,0
12/04/2017 23:10,18,68.8,33,64.1,51,65.8,2,0
12/04/2017 23:15,12,68.8,28,64.1,40,65.5,2,0
12/04/2017 23:20,15,69.2,30,64.5,45,66.1,2,0
12/04/2017 23:25,13,69.4,28,64.8,41,66.2,2,0
12/04/2017 23:30,15,69.2,30,64.5,45,66.1,2,0
12/04/2017 23:35,14,69.4,30,64.8,44,66.2,2,0
12/04/2017 23:40,14,69.4,30,64.8,44,66.2,2,0
12/04/2017 23:45,14,69.3,30,64.7,44,66.1,2,0
12/04/2017 23:50,9,69.2,24,64.5,33,65.8,2,0
12/04/2017 23:55,11,69.2,26,64.6,37,66,2,0
12/05/2017 0:00,11,69.3,27,64.7,38,66.1,2,0
12/05/2017 0:05,8,69.3,24,64.7,32,65.9,2,0
12/05/2017 0:10,8,69.3,24,64.7,32,65.8,2,0
12/05/2017 0:15,9,69.2,24,64.5,33,65.8,2,0
12/05/2017 0:20,8,69.3,23,64.7,31,65.9,2,0
12/05/2017 0:25,8,69.1,24,64.4,32,65.6,2,0
12/05/2017 0:30,7,69.1,22,64.5,29,65.6,2,0
12/05/2017 0:35,11,68.8,26,64.2,37,65.6,2,0
12/05/2017 0:40,7,68.8,22,64.2,29,65.3,2,0
12/05/2017 0:45,7,69,22,64.4,29,65.5,2,0
12/05/2017 0:50,5,69.1,21,64.4,26,65.3,2,0
12/05/2017 0:55,5,69.2,21,64.5,26,65.4,2,0
12/05/2017 1:00,10,69.1,20,64.5,30,66,2,0
12/05/2017 1:05,6,69.2,21,64.6,27,65.6,2,0
12/05/2017 1:10,7,69.2,22,64.6,29,65.7,2,0
12/05/2017 1:15,6,69.3,21,64.7,27,65.7,2,0
12/05/2017 1:20,5,69.3,20,64.7,25,65.7,2,0
12/05/2017 1:25,6,69.4,21,64.8,27,65.8,2,0
12/05/2017 1:30,8,69.3,24,64.7,32,65.9,2,0
12/05/2017 1:35,7,69.3,22,64.7,29,65.8,2,0
12/05/2017 1:40,7,69.3,22,64.7,29,65.8,2,0
12/05/2017 1:45,4,69.2,19,64.6,23,65.4,2,0
12/05/2017 1:50,7,69.3,23,64.7,30,65.8,2,0
12/05/2017 1:55,6,69.1,21,64.4,27,65.5,2,0
12/05/2017 2:00,6,69.2,22,64.5,28,65.5,2,0
12/05/2017 2:05,6,69.3,21,64.7,27,65.7,2,0
12/05/2017 2:10,6,69.3,21,64.7,27,65.7,2,0
12/05/2017 2:15,5,69.4,20,64.8,25,65.7,2,0
12/05/2017 2:20,6,69.4,22,64.8,28,65.8,2,0
12/05/2017 2:25,15,69.4,22,64.8,37,66.6,2,0
12/05/2017 2:30,9,69.3,25,64.7,34,65.9,2,0
12/05/2017 2:35,7,69.2,22,64.6,29,65.7,2,0
12/05/2017 2:40,10,69.3,25,64.7,35,66,2,0
12/05/2017 2:45,8,69.3,23,64.7,31,65.8,2,0
12/05/2017 2:50,7,69.1,23,64.5,30,65.6,2,0
12/05/2017 2:55,11,69.1,26,64.4,37,65.8,2,0
12/05/2017 3:00,8,69,24,64.4,32,65.5,2,0
12/05/2017 3:05,9,69.1,25,64.5,34,65.7,2,0
12/05/2017 3:10,9,68.7,25,64,34,65.2,2,0
12/05/2017 3:15,11,69,26,64.4,37,65.7,2,0
12/05/2017 3:20,8,68.9,24,64.3,32,65.4,2,0
12/05/2017 3:25,9,69.2,25,64.5,34,65.8,2,0
12/05/2017 3:30,14,69.1,30,64.5,44,65.9,2,0
12/05/2017 3:35,14,69.1,29,64.5,43,66,2,0
12/05/2017 3:40,11,69.1,27,64.5,38,65.8,2,0
12/05/2017 3:45,8,69.3,24,64.7,32,65.9,2,0
12/05/2017 3:50,15,69.3,31,64.7,46,66.2,2,0
12/05/2017 3:55,12,69.4,28,64.8,40,66.2,2,0
12/05/2017 4:00,14,69.1,30,64.4,44,65.9,2,0
12/05/2017 4:05,20,68.9,37,64.2,57,65.8,2,0
12/05/2017 4:10,19,68.7,34,64,53,65.7,2,0
12/05/2017 4:15,22,68.8,37,64.2,59,65.9,2,0
12/05/2017 4:20,20,68,37,63.3,57,65,2,0
12/05/2017 4:25,26,68.3,42,63.6,68,65.4,2,0
12/05/2017 4:30,29,68.9,45,64.2,74,66.1,2,0
12/05/2017 4:35,44,69.1,63,64.5,107,66.4,2,0
12/05/2017 4:40,33,69.3,51,64.7,84,66.5,2,0
12/05/2017 4:45,41,69.9,60,65.3,101,67.2,2,0
12/05/2017 4:50,36,69.6,54,65,90,66.9,2,0
12/05/2017 4:55,40,68.8,58,64.2,98,66,2,0
12/05/2017 5:00,43,68.7,62,64,105,65.9,2,0
12/05/2017 5:05,43,69.5,62,64.9,105,66.8,2,0
12/05/2017 5:10,50,68.6,70,63.9,120,65.9,2,0
12/05/2017 5:15,52,68.5,71,63.8,123,65.8,2,0
12/05/2017 5:20,60,67.8,81,62.9,141,65,2,0
12/05/2017 5:25,52,68.7,71,64,123,66,2,0
12/05/2017 5:30,56,69.2,76,64.5,132,66.5,2,0
12/05/2017 5:35,59,68.9,80,64.2,139,66.2,2,0
12/05/2017 5:40,59,68.1,80,63.2,139,65.3,2,0
12/05/2017 5:45,71,66.7,93,61.8,164,63.9,2,0
12/05/2017 5:50,62,67.2,83,62.3,145,64.4,2,0
12/05/2017 5:55,48,68.2,68,63.4,116,65.4,2,0
12/05/2017 6:00,51,66.7,71,61.6,122,63.7,2,0
12/05/2017 6:05,57,67,78,61.9,135,64.1,2,0
12/05/2017 6:10,57,66.5,78,61.5,135,63.6,2,0
12/05/2017 6:15,60,67.2,82,62.3,142,64.4,2,0
12/05/2017 6:20,65,67.2,86,62.2,151,64.4,2,0
12/05/2017 6:25,56,67.2,77,62.2,133,64.3,2,0
12/05/2017 6:30,57,66.6,77,61.6,134,63.7,2,0
12/05/2017 6:35,69,66.7,91,61.7,160,63.9,2,0
12/05/2017 6:40,63,66.8,85,61.9,148,64,2,0
12/05/2017 6:45,82,66.3,105,61.4,187,63.5,2,0
12/05/2017 6:50,82,66.2,105,61.2,187,63.4,2,0
12/05/2017 6:55,73,67.4,94,62.5,167,64.6,2,0
12/05/2017 7:00,84,67.1,108,62.2,192,64.3,2,0
12/05/2017 7:05,79,65.7,104,60.6,183,62.8,2,0
12/05/2017 7:10,82,66.3,104,61.3,186,63.5,2,0
12/05/2017 7:15,86,67.1,109,62.2,195,64.4,2,0
12/05/2017 7:20,78,66,100,61,178,63.2,2,0
12/05/2017 7:25,77,66.1,100,61.1,177,63.3,2,0
12/05/2017 7:30,90,65.3,114,60.3,204,62.5,2,0
12/05/2017 7:35,87,65.3,111,60.2,198,62.4,2,0
12/05/2017 7:40,90,64.8,114,59.7,204,62,2,0
12/05/2017 7:45,89,65.2,114,60.1,203,62.3,2,0
12/05/2017 7:50,85,64.6,109,59.5,194,61.7,2,0
12/05/2017 7:55,81,65.5,104,60.5,185,62.7,2,0
12/05/2017 8:00,81,65.7,103,60.7,184,62.9,2,0
12/05/2017 8:05,79,65.5,102,60.5,181,62.7,2,0
12/05/2017 8:10,82,65.8,105,60.8,187,63,2,0
12/05/2017 8:15,75,66.3,97,61.3,172,63.5,2,0
12/05/2017 8:20,70,66.1,91,61.1,161,63.2,2,0
12/05/2017 8:25,80,66.7,102,61.8,182,63.9,2,0
12/05/2017 8:30,84,65.5,106,60.4,190,62.7,2,0
12/05/2017 8:35,83,64.6,106,59.4,189,61.7,2,0
12/05/2017 8:40,81,64.4,103,59.2,184,61.5,2,0
12/05/2017 8:45,81,64.8,103,59.7,184,61.9,2,0
12/05/2017 8:50,86,66,108,61,194,63.2,2,0
12/05/2017 8:55,84,65.7,107,60.6,191,62.8,2,0
12/05/2017 9:00,87,63.8,111,58.5,198,60.9,2,0
12/05/2017 9:05,84,63.5,108,58.2,192,60.5,2,0
12/05/2017 9:10,79,65.2,100,60.1,179,62.4,2,0
12/05/2017 9:15,66,66.2,88,61.1,154,63.3,2,0
12/05/2017 9:20,72,66.8,94,61.8,166,63.9,2,0
12/05/2017 9:25,77,66.6,98,61.6,175,63.8,2,0
12/05/2017 9:30,72,66,93,61.1,165,63.2,2,0
12/05/2017 9:35,80,65.4,101,60.3,181,62.6,2,0
12/05/2017 9:40,73,64.3,93,59.2,166,61.4,2,0
12/05/2017 9:45,65,64.4,85,59.3,150,61.5,2,0
12/05/2017 9:50,79,64.1,101,58.9,180,61.2,2,0
12/05/2017 9:55,69,65.4,90,60.4,159,62.6,2,0
12/05/2017 10:00,60,65.1,79,60.1,139,62.3,2,0
12/05/2017 10:05,63,67.1,83,62.4,146,64.4,2,0
12/05/2017 10:10,61,67.3,80,62.6,141,64.6,2,0
12/05/2017 10:15,56,67.7,73,63,129,65,2,0
12/05/2017 10:20,61,67.3,79,62.6,140,64.7,2,0
12/05/2017 10:25,64,67.8,82,63.1,146,65.2,2,0
12/05/2017 10:30,63,68.4,82,63.8,145,65.8,2,0
12/05/2017 10:35,62,68.1,81,63.5,143,65.5,2,0
12/05/2017 10:40,58,68.4,76,63.8,134,65.8,2,0
12/05/2017 10:45,45,69.3,62,64.7,107,66.6,2,0
12/05/2017 10:50,64,68.3,84,63.6,148,65.6,2,0
12/05/2017 10:55,59,68.4,77,63.8,136,65.8,2,0
12/05/2017 11:00,57,69,75,64.5,132,66.4,2,0
12/05/2017 11:05,52,68,70,63.3,122,65.3,2,0
12/05/2017 11:10,51,68.1,70,63.3,121,65.3,2,0
12/05/2017 11:15,60,68.4,79,63.7,139,65.7,2,0
12/05/2017 11:20,53,68,71,63.3,124,65.3,2,0
12/05/2017 11:25,58,68.4,77,63.7,135,65.7,2,0
12/05/2017 11:30,67,67,86,62.2,153,64.3,2,0
12/05/2017 11:35,57,67,76,62.1,133,64.2,2,0
12/05/2017 11:40,58,68.4,78,63.7,136,65.7,2,0
12/05/2017 11:45,52,69.2,70,64.7,122,66.6,2,0
12/05/2017 11:50,55,68.7,73,64,128,66,2,0
12/05/2017 11:55,55,69,74,64.4,129,66.4,2,0
12/05/2017 12:00,48,69.5,65,64.9,113,66.9,2,0
12/05/2017 12:05,49,68.3,68,63.7,117,65.6,2,0
12/05/2017 12:10,44,68,62,63.3,106,65.3,2,0
12/05/2017 12:15,54,68,72,63.3,126,65.3,2,0
12/05/2017 12:20,50,68.5,68,63.8,118,65.8,2,0
12/05/2017 12:25,45,68.2,62,63.5,107,65.4,2,0
12/05/2017 12:30,47,66.4,65,61.6,112,63.7,2,0
12/05/2017 12:35,56,66.9,75,62.1,131,64.2,2,0
12/05/2017 12:40,59,68.8,77,64.2,136,66.2,2,0
12/05/2017 12:45,57,68.3,75,63.7,132,65.7,2,0
12/05/2017 12:50,55,69.4,73,64.8,128,66.7,2,0
12/05/2017 12:55,50,68.6,68,63.8,118,65.9,2,0
12/05/2017 13:00,48,66.6,66,61.8,114,63.8,2,0
12/05/2017 13:05,48,67.1,67,62.2,115,64.2,2,0
12/05/2017 13:10,46,68,64,63.4,110,65.3,2,0
12/05/2017 13:15,45,68.9,62,64.2,107,66.2,2,0
12/05/2017 13:20,45,68.7,63,64,108,66,2,0
12/05/2017 13:25,38,68.3,56,63.6,94,65.5,2,0
12/05/2017 13:30,43,69.7,59,65.1,102,67.1,2,0
12/05/2017 13:35,53,68.2,72,63.5,125,65.5,2,0
12/05/2017 13:40,48,69,65,64.4,113,66.4,2,0
12/05/2017 13:45,49,68.6,66,63.9,115,65.9,2,0
12/05/2017 13:50,50,68.1,67,63.3,117,65.4,2,0
12/05/2017 13:55,49,68.5,67,63.8,116,65.8,2,0
12/05/2017 14:00,47,67.7,64,63.1,111,65.1,2,0
12/05/2017 14:05,48,69,65,64.4,113,66.3,2,0
12/05/2017 14:10,47,68.8,64,64.2,111,66.1,2,0
12/05/2017 14:15,51,69.7,69,65,120,67,2,0
12/05/2017 14:20,46,70,64,65.5,110,67.4,2,0
12/05/2017 14:25,49,68.7,67,64,116,66,2,0
12/05/2017 14:30,50,68.4,68,63.7,118,65.7,2,0
12/05/2017 14:35,49,68.4,67,63.7,116,65.7,2,0
12/05/2017 14:40,57,68.3,75,63.6,132,65.6,2,0
12/05/2017 14:45,52,69.4,71,64.8,123,66.7,2,0
12/05/2017 14:50,47,67.8,65,63.1,112,65,2,0
12/05/2017 14:55,41,68.5,57,63.9,98,65.8,2,0
12/05/2017 15:00,49,67.5,67,62.8,116,64.8,2,0
12/05/2017 15:05,52,68,70,63.4,122,65.3,2,0
12/05/2017 15:10,49,67.9,68,63.3,117,65.2,2,0
12/05/2017 15:15,51,68,69,63.3,120,65.3,2,0
12/05/2017 15:20,51,68.7,70,64.1,121,66.1,2,0
12/05/2017 15:25,65,70,83,65.6,148,67.5,2,0
12/05/2017 15:30,56,69.2,74,64.7,130,66.6,2,0
12/05/2017 15:35,55,69.5,74,65,129,66.9,2,0
12/05/2017 15:40,70,68.6,89,64.1,159,66.1,2,0
12/05/2017 15:45,57,68.1,77,63.5,134,65.5,2,0
12/05/2017 15:50,63,67.6,82,63,145,65,2,0
12/05/2017 15:55,65,67.9,84,63.3,149,65.3,2,0
12/05/2017 16:00,64,68,83,63.3,147,65.4,2,0
12/05/2017 16:05,58,67.6,75,62.8,133,64.9,2,0
12/05/2017 16:10,61,68,80,63.3,141,65.3,2,0
12/05/2017 16:15,58,64.9,77,59.9,135,62.1,2,0
12/05/2017 16:20,53,65,72,60,125,62.1,2,0
12/05/2017 16:25,57,64.8,75,59.8,132,61.9,2,0
12/05/2017 16:30,47,65,65,60,112,62.1,2,0
12/05/2017 16:35,43,66.9,61,62.1,104,64.1,2,0
12/05/2017 16:40,42,67.9,60,63.1,102,65.1,2,0
12/05/2017 16:45,42,68.3,59,63.7,101,65.6,2,0
12/05/2017 16:50,43,68.9,61,64.3,104,66.2,2,0
12/05/2017 16:55,44,67.9,61,63.2,105,65.2,2,0
12/05/2017 17:00,45,69.8,63,65.2,108,67.1,2,0
12/05/2017 17:05,47,70,66,65.4,113,67.3,2,0
12/05/2017 17:10,52,69.4,71,64.7,123,66.7,2,0
12/05/2017 17:15,53,69.8,72,65.1,125,67.1,2,0
12/05/2017 17:20,57,67.4,76,62.4,133,64.5,2,0
12/05/2017 17:25,44,66.9,61,61.9,105,64,2,0
12/05/2017 17:30,47,63.3,66,58,113,60.2,2,0
12/05/2017 17:35,50,64.1,68,58.9,118,61.2,2,0
12/05/2017 17:40,47,66.2,65,61.2,112,63.3,2,0
12/05/2017 17:45,48,68.4,65,63.6,113,65.6,2,0
12/05/2017 17:50,47,69.1,65,64.4,112,66.4,2,0
12/05/2017 17:55,51,67.8,69,63,120,65,2,0
12/05/2017 18:00,46,66.9,64,62,110,64.1,2,0
12/05/2017 18:05,46,67.9,64,63.1,110,65.1,2,0
12/05/2017 18:10,47,68.6,65,63.9,112,65.9,2,0
12/05/2017 18:15,51,70,68,65.4,119,67.4,2,0
12/05/2017 18:20,51,69.7,69,65.1,120,67.1,2,0
12/05/2017 18:25,56,68.9,74,64.2,130,66.3,2,0
12/05/2017 18:30,56,67.3,76,62.4,132,64.5,2,0
12/05/2017 18:35,58,67.7,77,62.9,135,65,2,0
12/05/2017 18:40,51,68.4,69,63.6,120,65.6,2,0
12/05/2017 18:45,46,69.3,63,64.5,109,66.6,2,0
12/05/2017 18:50,50,69.4,69,64.7,119,66.7,2,0
12/05/2017 18:55,49,70,66,65.4,115,67.3,2,0
12/05/2017 19:00,53,68.7,71,63.9,124,66,2,0
12/05/2017 19:05,55,67.2,73,62.4,128,64.5,2,0
12/05/2017 19:10,48,67,65,62.2,113,64.2,2,0
12/05/2017 19:15,41,68.5,59,63.8,100,65.7,2,0
12/05/2017 19:20,36,69.4,53,64.8,89,66.6,2,0
12/05/2017 19:25,45,69.5,63,64.8,108,66.8,2,0
12/05/2017 19:30,39,69.8,55,65.2,94,67.1,2,0
12/05/2017 19:35,35,69.6,52,64.9,87,66.8,2,0
12/05/2017 19:40,33,69.3,50,64.7,83,66.6,2,0
12/05/2017 19:45,42,68.5,60,63.8,102,65.7,2,0
12/05/2017 19:50,30,69.4,46,64.7,76,66.6,2,0
12/05/2017 19:55,29,69.7,44,65.1,73,66.9,2,0
12/05/2017 20:00,34,69.5,51,64.8,85,66.7,2,0
12/05/2017 20:05,34,69,51,64.3,85,66.1,2,0
12/05/2017 20:10,27,69.3,43,64.7,70,66.5,2,0
12/05/2017 20:15,30,69.4,46,64.7,76,66.6,2,0
12/05/2017 20:20,33,68.9,49,64.3,82,66.2,2,0
12/05/2017 20:25,29,69.5,45,64.8,74,66.6,2,0
12/05/2017 20:30,35,69.3,52,64.7,87,66.5,2,0
12/05/2017 20:35,22,69.4,38,64.8,60,66.5,2,0
12/05/2017 20:40,25,69.1,42,64.5,67,66.2,2,0
12/05/2017 20:45,29,69.3,45,64.6,74,66.4,2,0
12/05/2017 20:50,36,68.5,53,63.8,89,65.7,2,0
12/05/2017 20:55,29,68.6,46,63.9,75,65.7,2,0
12/05/2017 21:00,23,68.2,39,63.4,62,65.2,2,0
12/05/2017 21:05,26,68.5,42,63.9,68,65.7,2,0
12/05/2017 21:10,32,69.1,49,64.5,81,66.3,2,0
12/05/2017 21:15,28,69.5,44,64.9,72,66.7,2,0
12/05/2017 21:20,22,68.9,39,64.3,61,66,2,0
12/05/2017 21:25,26,69.3,43,64.7,69,66.4,2,0
12/05/2017 21:30,25,68.3,42,63.6,67,65.3,2,0
12/05/2017 21:35,24,67.8,40,63.1,64,64.9,2,0
12/05/2017 21:40,22,68.9,37,64.3,59,66,2,0
12/05/2017 21:45,23,69,40,64.4,63,66.1,2,0
12/05/2017 21:50,21,69.4,36,64.8,57,66.5,2,0
12/05/2017 21:55,23,69.2,39,64.6,62,66.3,2,0
12/05/2017 22:00,25,68.9,41,64.2,66,66,2,0
12/05/2017 22:05,16,69.1,31,64.5,47,66,2,0
12/05/2017 22:10,23,69.1,39,64.5,62,66.2,2,0
12/05/2017 22:15,21,69.2,37,64.5,58,66.2,2,0
12/05/2017 22:20,15,69.3,30,64.7,45,66.2,2,0
12/05/2017 22:25,21,69.3,36,64.6,57,66.3,2,0
12/05/2017 22:30,20,69.4,36,64.8,56,66.5,2,0
12/05/2017 22:35,15,69.4,31,64.8,46,66.3,2,0
12/05/2017 22:40,18,68.9,34,64.3,52,65.9,2,0
12/05/2017 22:45,23,69.3,40,64.7,63,66.4,2,0
12/05/2017 22:50,17,69.2,33,64.6,50,66.2,2,0
12/05/2017 22:55,18,69.2,34,64.6,52,66.2,2,0
12/05/2017 23:00,20,69.1,36,64.5,56,66.2,2,0
12/05/2017 23:05,19,68.8,34,64.1,53,65.8,2,0
12/05/2017 23:10,15,69,30,64.4,45,65.9,2,0
12/05/2017 23:15,18,68.9,33,64.3,51,65.9,2,0
12/05/2017 23:20,15,68.9,30,64.3,45,65.8,2,0
12/05/2017 23:25,18,69.3,33,64.7,51,66.4,2,0
12/05/2017 23:30,16,69.4,31,64.8,47,66.3,2,0
12/05/2017 23:35,18,69.5,33,64.9,51,66.5,2,0
12/05/2017 23:40,14,69.3,30,64.7,44,66.2,2,0
12/05/2017 23:45,12,69.4,28,64.8,40,66.1,2,0
12/05/2017 23:50,11,69.4,27,64.8,38,66.1,2,0
12/05/2017 23:55,11,69.2,26,64.6,37,66,2,0
12/06/2017 0:00,11,69.3,27,64.7,38,66.1,2,0
12/06/2017 0:05,15,69.4,31,64.8,46,66.3,2,0
12/06/2017 0:10,11,69.1,26,64.5,37,65.8,2,0
12/06/2017 0:15,7,69.2,22,64.6,29,65.7,2,0
12/06/2017 0:20,8,69.3,24,64.7,32,65.9,2,0
12/06/2017 0:25,11,69.2,27,64.5,38,65.9,2,0
12/06/2017 0:30,9,68.8,25,64.2,34,65.4,2,0
12/06/2017 0:35,7,68.9,22,64.3,29,65.4,2,0
12/06/2017 0:40,9,69.1,24,64.5,33,65.8,2,0
12/06/2017 0:45,5,69.3,21,64.7,26,65.5,2,0
12/06/2017 0:50,10,69.3,20,64.7,30,66.2,2,0
12/06/2017 0:55,7,69.4,22,64.8,29,66,2,0
12/06/2017 1:00,6,69.1,21,64.5,27,65.5,2,0
12/06/2017 1:05,6,69.2,21,64.6,27,65.6,2,0
12/06/2017 1:10,5,69.3,21,64.7,26,65.6,2,0
12/06/2017 1:15,5,69.4,20,64.8,25,65.7,2,0
12/06/2017 1:20,7,69.3,22,64.7,29,65.8,2,0
12/06/2017 1:25,7,69.3,22,64.7,29,65.8,2,0
12/06/2017 1:30,7,69.2,22,64.5,29,65.7,2,0
12/06/2017 1:35,9,69.2,24,64.5,33,65.8,2,0
12/06/2017 1:40,6,69.2,21,64.6,27,65.6,2,0
12/06/2017 1:45,7,69.3,22,64.7,29,65.8,2,0
12/06/2017 1:50,5,69.3,20,64.7,25,65.7,2,0
12/06/2017 1:55,8,69.3,19,64.7,27,66.1,2,0
12/06/2017 2:00,7,69.4,22,64.8,29,65.9,2,0
12/06/2017 2:05,7,69.4,22,64.8,29,66,2,0
12/06/2017 2:10,8,69.4,23,64.8,31,66,2,0
12/06/2017 2:15,7,69.4,22,64.8,29,65.9,2,0
12/06/2017 2:20,7,69.1,22,64.5,29,65.6,2,0
12/06/2017 2:25,7,69.2,22,64.6,29,65.7,2,0
12/06/2017 2:30,6,69.4,22,64.8,28,65.8,2,0
12/06/2017 2:35,8,69.4,24,64.8,32,65.9,2,0
12/06/2017 2:40,8,69.4,23,64.8,31,66,2,0
12/06/2017 2:45,8,69.4,24,64.8,32,65.9,2,0
12/06/2017 2:50,9,69.5,25,64.9,34,66.1,2,0
12/06/2017 2:55,11,69.2,26,64.6,37,66,2,0
12/06/2017 3:00,10,69.3,25,64.7,35,66,2,0
12/06/2017 3:05,12,68.8,28,64.2,40,65.6,2,0
12/06/2017 3:10,10,68.9,25,64.2,35,65.6,2,0
12/06/2017 3:15,8,68.9,24,64.3,32,65.5,2,0
12/06/2017 3:20,10,69.1,25,64.5,35,65.8,2,0
12/06/2017 3:25,11,69,27,64.4,38,65.7,2,0
12/06/2017 3:30,13,69.2,29,64.6,42,66,2,0
12/06/2017 3:35,12,69.3,28,64.7,40,66.1,2,0
12/06/2017 3:40,13,69.5,29,64.9,42,66.3,2,0
12/06/2017 3:45,14,69.5,29,64.9,43,66.4,2,0
12/06/2017 3:50,19,69.7,35,65.1,54,66.7,2,0
12/06/2017 3:55,12,69.6,27,65,39,66.4,2,0
12/06/2017 4:00,20,69.4,37,64.8,57,66.4,2,0
12/06/2017 4:05,18,69.4,34,64.8,52,66.4,2,0
12/06/2017 4:10,19,69.3,35,64.6,54,66.3,2,0
12/06/2017 4:15,22,69.4,38,64.8,60,66.5,2,0
12/06/2017 4:20,21,69.3,37,64.7,58,66.4,2,0
12/06/2017 4:25,27,69.8,44,65.2,71,67,2,0
12/06/2017 4:30,26,69.2,43,64.6,69,66.3,2,0
12/06/2017 4:35,30,68.8,47,64.1,77,65.9,2,0
12/06/2017 4:40,37,68.6,54,63.8,91,65.8,2,0
12/06/2017 4:45,36,68.9,54,64.1,90,66,2,0
12/06/2017 4:50,31,69.6,48,64.9,79,66.7,2,0
12/06/2017 4:55,43,69.5,62,64.8,105,66.7,2,0
12/06/2017 5:00,38,69.9,56,65.3,94,67.1,2,0
12/06/2017 5:05,51,68.6,71,63.9,122,65.9,2,0
12/06/2017 5:10,45,68.5,64,63.9,109,65.8,2,0
12/06/2017 5:15,55,68.9,75,64.3,130,66.2,2,0
12/06/2017 5:20,58,69.1,78,64.4,136,66.4,2,0
12/06/2017 5:25,51,69.1,71,64.5,122,66.4,2,0
12/06/2017 5:30,60,68.3,81,63.6,141,65.6,2,0
12/06/2017 5:35,60,69.2,81,64.5,141,66.5,2,0
12/06/2017 5:40,69,69.7,91,65.2,160,67.1,2,0
12/06/2017 5:45,62,70.4,84,65.9,146,67.8,2,0
12/06/2017 5:50,62,70.4,83,65.9,145,67.8,2,0
12/06/2017 5:55,62,69.3,82,64.7,144,66.7,2,0
12/06/2017 6:00,55,68.3,77,63.5,132,65.5,2,0
12/06/2017 6:05,53,68.6,73,63.8,126,65.8,2,0
12/06/2017 6:10,58,67.5,77,62.6,135,64.7,2,0
12/06/2017 6:15,64,68,86,63.2,150,65.2,2,0
12/06/2017 6:20,66,66.6,88,61.6,154,63.7,2,0
12/06/2017 6:25,69,66.8,91,61.9,160,64,2,0
12/06/2017 6:30,59,67.5,79,62.5,138,64.6,2,0
12/06/2017 6:35,77,67.8,100,62.9,177,65,2,0
12/06/2017 6:40,65,68.1,86,63.2,151,65.3,2,0
12/06/2017 6:45,85,67.1,108,62.1,193,64.3,2,0
12/06/2017 6:50,78,66.8,100,61.9,178,64,2,0
12/06/2017 6:55,77,68.6,100,63.8,177,65.9,2,0
12/06/2017 7:00,72,68.4,94,63.6,166,65.7,2,0
12/06/2017 7:05,77,68.5,99,63.6,176,65.8,2,0
12/06/2017 7:10,75,67.7,98,62.9,173,65,2,0
12/06/2017 7:15,79,67.8,102,63,181,65.1,2,0
12/06/2017 7:20,76,67.2,99,62.3,175,64.4,2,0
12/06/2017 7:25,91,67.6,114,62.8,205,64.9,2,0
12/06/2017 7:30,81,68.1,104,63.3,185,65.4,2,0
12/06/2017 7:35,81,67.2,104,62.3,185,64.5,2,0
12/06/2017 7:40,87,67.3,111,62.4,198,64.6,2,0
12/06/2017 7:45,90,67.6,113,62.6,203,64.8,2,0
12/06/2017 7:50,91,66.4,116,61.5,207,63.6,2,0
12/06/2017 7:55,74,65.4,96,60.4,170,62.6,2,0
12/06/2017 8:00,76,65.7,97,60.7,173,62.9,2,0
12/06/2017 8:05,73,65.6,97,60.6,170,62.7,2,0
12/06/2017 8:10,81,66.6,104,61.6,185,63.8,2,0
12/06/2017 8:15,81,65.6,104,60.6,185,62.8,2,0
12/06/2017 8:20,83,64.2,107,59,190,61.3,2,0
12/06/2017 8:25,79,65.4,103,60.3,182,62.5,2,0
12/06/2017 8:30,77,65.8,99,60.8,176,63,2,0
12/06/2017 8:35,92,64.8,116,59.6,208,61.9,2,0
12/06/2017 8:40,80,66,103,61,183,63.2,2,0
12/06/2017 8:45,85,64.8,109,59.7,194,61.9,2,0
12/06/2017 8:50,79,64.6,102,59.5,181,61.8,2,0
12/06/2017 8:55,69,65.2,90,60.2,159,62.3,2,0
12/06/2017 9:00,77,65.6,99,60.6,176,62.8,2,0
12/06/2017 9:05,76,66.4,98,61.4,174,63.6,2,0
12/06/2017 9:10,70,66.4,90,61.5,160,63.7,2,0
12/06/2017 9:15,71,67.4,93,62.5,164,64.6,2,0
12/06/2017 9:20,63,66.3,84,61.3,147,63.4,2,0
12/06/2017 9:25,72,64,93,58.9,165,61.1,2,0
12/06/2017 9:30,70,65.3,90,60.3,160,62.5,2,0
12/06/2017 9:35,65,66.4,86,61.5,151,63.6,2,0
12/06/2017 9:40,79,65.8,101,60.8,180,63,2,0
12/06/2017 9:45,64,65.9,84,61,148,63.2,2,0
12/06/2017 9:50,60,64.7,80,59.6,140,61.8,2,0
12/06/2017 9:55,60,65.7,79,60.7,139,62.8,2,0
12/06/2017 10:00,60,65.4,80,60.5,140,62.6,2,0
12/06/2017 10:05,59,66.8,78,62,137,64,2,0
12/06/2017 10:10,61,68.9,79,64.3,140,66.3,2,0
12/06/2017 10:15,60,69.4,79,64.9,139,66.8,2,0
12/06/2017 10:20,65,69.2,84,64.6,149,66.6,2,0
12/06/2017 10:25,63,67.7,82,63,145,65.1,2,0
12/06/2017 10:30,61,67.7,79,63,140,65,2,0
12/06/2017 10:35,53,68,72,63.3,125,65.3,2,0
12/06/2017 10:40,66,67.7,86,63,152,65,2,0
12/06/2017 10:45,56,67.1,76,62.4,132,64.4,2,0
12/06/2017 10:50,59,67.7,77,62.9,136,65,2,0
12/06/2017 10:55,51,68.6,70,64,121,66,2,0
12/06/2017 11:00,48,68.6,66,64,114,65.9,2,0
12/06/2017 11:05,55,69.1,73,64.5,128,66.4,2,0
12/06/2017 11:10,51,70,69,65.4,120,67.4,2,0
12/06/2017 11:15,59,69.3,77,64.7,136,66.7,2,0
12/06/2017 11:20,58,69.3,77,64.7,135,66.7,2,0
12/06/2017 11:25,57,69.4,75,64.8,132,66.8,2,0
12/06/2017 11:30,53,67.8,71,63,124,65,2,0
12/06/2017 11:35,61,68.8,79,64.1,140,66.1,2,0
12/06/2017 11:40,54,70.1,73,65.5,127,67.4,2,0
12/06/2017 11:45,59,68.8,78,64,137,66.1,2,0
12/06/2017 11:50,63,69.4,82,64.8,145,66.8,2,0
12/06/2017 11:55,53,69.3,71,64.6,124,66.6,2,0
12/06/2017 12:00,47,70.2,64,65.6,111,67.6,2,0
12/06/2017 12:05,58,69.5,78,64.9,136,66.9,2,0
12/06/2017 12:10,52,67.8,71,63,123,65,2,0
12/06/2017 12:15,53,68.4,70,63.7,123,65.7,2,0
12/06/2017 12:20,48,68.5,66,63.8,114,65.8,2,0
12/06/2017 12:25,50,68.5,68,63.7,118,65.7,2,0
12/06/2017 12:30,50,69.9,69,65.2,119,67.2,2,0
12/06/2017 12:35,50,69.7,68,65.1,118,67.1,2,0
12/06/2017 12:40,57,68.2,76,63.6,133,65.6,2,0
12/06/2017 12:45,52,68.6,71,63.9,123,65.8,2,0
12/06/2017 12:50,51,68.1,69,63.3,120,65.4,2,0
12/06/2017 12:55,41,68.8,58,64.1,99,66,2,0
12/06/2017 13:00,47,69,65,64.4,112,66.3,2,0
12/06/2017 13:05,48,68.5,65,63.8,113,65.8,2,0
12/06/2017 13:10,47,68.9,66,64.2,113,66.1,2,0
12/06/2017 13:15,53,68,72,63.2,125,65.3,2,0
12/06/2017 13:20,53,68.1,72,63.3,125,65.4,2,0
12/06/2017 13:25,50,66.2,68,61.2,118,63.4,2,0
12/06/2017 13:30,48,68.6,65,63.9,113,65.9,2,0
12/06/2017 13:35,49,68.5,67,63.8,116,65.8,2,0
12/06/2017 13:40,51,69.1,70,64.4,121,66.4,2,0
12/06/2017 13:45,55,68.9,74,64.3,129,66.3,2,0
12/06/2017 13:50,43,69.5,61,64.9,104,66.8,2,0
12/06/2017 13:55,48,69.1,65,64.5,113,66.5,2,0
12/06/2017 14:00,46,68.1,64,63.3,110,65.3,2,0
12/06/2017 14:05,45,68.1,62,63.3,107,65.3,2,0
12/06/2017 14:10,45,68.1,62,63.4,107,65.4,2,0
12/06/2017 14:15,46,68.4,64,63.7,110,65.7,2,0
12/06/2017 14:20,40,69.2,58,64.6,98,66.5,2,0
12/06/2017 14:25,50,69.3,68,64.6,118,66.6,2,0
12/06/2017 14:30,48,69.3,65,64.6,113,66.6,2,0
12/06/2017 14:35,51,67.6,69,62.8,120,64.8,2,0
12/06/2017 14:40,52,68,68,63.3,120,65.3,2,0
12/06/2017 14:45,50,68.8,69,64.1,119,66.1,2,0
12/06/2017 14:50,44,68.8,62,64.1,106,66.1,2,0
12/06/2017 14:55,47,67.3,65,62.5,112,64.5,2,0
12/06/2017 15:00,44,68.9,61,64.3,105,66.2,2,0
12/06/2017 15:05,45,69.3,63,64.7,108,66.6,2,0
12/06/2017 15:10,51,69.6,69,65.1,120,67,2,0
12/06/2017 15:15,48,68.7,66,64.1,114,66.1,2,0
12/06/2017 15:20,49,68.3,67,63.7,116,65.6,2,0
12/06/2017 15:25,54,69,71,64.4,125,66.4,2,0
12/06/2017 15:30,51,68.9,69,64.2,120,66.2,2,0
12/06/2017 15:35,60,69.3,79,64.8,139,66.7,2,0
12/06/2017 15:40,66,69.6,85,65.1,151,67.1,2,0
12/06/2017 15:45,62,69.8,81,65.2,143,67.2,2,0
12/06/2017 15:50,62,69.4,81,64.8,143,66.8,2,0
12/06/2017 15:55,56,69.7,74,65.1,130,67.1,2,0
12/06/2017 16:00,60,69.5,78,64.8,138,66.8,2,0
12/06/2017 16:05,64,68.4,82,63.7,146,65.8,2,0
12/06/2017 16:10,64,68.1,84,63.5,148,65.5,2,0
12/06/2017 16:15,57,69.2,76,64.7,133,66.7,2,0
12/06/2017 16:20,55,69.9,73,65.4,128,67.4,2,0
12/06/2017 16:25,47,70.8,65,66.3,112,68.2,2,0
12/06/2017 16:30,57,70.4,75,66,132,67.9,2,0
12/06/2017 16:35,45,69.4,62,65,107,66.8,2,0
12/06/2017 16:40,62,69.1,81,64.5,143,66.5,2,0
12/06/2017 16:45,54,69.5,73,64.9,127,66.8,2,0
12/06/2017 16:50,46,70,63,65.4,109,67.4,2,0
12/06/2017 16:55,51,68,69,63.2,120,65.2,2,0
12/06/2017 17:00,50,68.2,67,63.4,117,65.5,2,0
12/06/2017 17:05,44,68.6,62,63.9,106,65.8,2,0
12/06/2017 17:10,62,67.6,81,62.8,143,64.9,2,0
12/06/2017 17:15,56,67.4,76,62.6,132,64.6,2,0
12/06/2017 17:20,55,67.7,73,63,128,65,2,0
12/06/2017 17:25,57,62.9,77,57.6,134,59.9,2,0
12/06/2017 17:30,51,61.2,69,55.7,120,58,2,0
12/06/2017 17:35,51,61.5,68,55.9,119,58.3,2,0
12/06/2017 17:40,48,64.7,65,59.5,113,61.7,2,0
12/06/2017 17:45,50,65.9,68,60.9,118,63,2,0
12/06/2017 17:50,44,66.3,61,61.3,105,63.4,2,0
12/06/2017 17:55,38,66.8,55,61.9,93,63.9,2,0
12/06/2017 18:00,53,67.5,71,62.7,124,64.8,2,0
12/06/2017 18:05,47,68.8,65,64.1,112,66.1,2,0
12/06/2017 18:10,47,68.9,64,64.2,111,66.2,2,0
12/06/2017 18:15,50,68,68,63.3,118,65.3,2,0
12/06/2017 18:20,46,68.2,63,63.5,109,65.5,2,0
12/06/2017 18:25,43,69,61,64.5,104,66.4,2,0
12/06/2017 18:30,41,69,59,64.5,100,66.3,2,0
12/06/2017 18:35,47,68.7,65,64,112,66,2,0
12/06/2017 18:40,45,69.1,62,64.4,107,66.4,2,0
12/06/2017 18:45,37,68.9,55,64.2,92,66.1,2,0
12/06/2017 18:50,35,69.2,52,64.6,87,66.5,2,0
12/06/2017 18:55,43,69.4,60,64.8,103,66.8,2,0
12/06/2017 19:00,43,67.5,60,62.9,103,64.8,2,0
12/06/2017 19:05,42,67.7,59,62.9,101,64.9,2,0
12/06/2017 19:10,43,68.2,61,63.6,104,65.5,2,0
12/06/2017 19:15,41,68.5,59,63.8,100,65.7,2,0
12/06/2017 19:20,37,68.4,55,63.7,92,65.6,2,0
12/06/2017 19:25,39,67.4,56,62.6,95,64.6,2,0
12/06/2017 19:30,42,68.3,58,63.6,100,65.6,2,0
12/06/2017 19:35,38,68.7,54,64,92,65.9,2,0
12/06/2017 19:40,44,68.5,62,63.8,106,65.7,2,0
12/06/2017 19:45,35,68.9,52,64.3,87,66.2,2,0
12/06/2017 19:50,30,69.6,46,65,76,66.8,2,0
12/06/2017 19:55,36,69.8,53,65.3,89,67.1,2,0
12/06/2017 20:00,31,69.1,48,64.5,79,66.3,2,0
12/06/2017 20:05,31,68.8,47,64.1,78,65.9,2,0
12/06/2017 20:10,28,69.1,44,64.5,72,66.3,2,0
12/06/2017 20:15,31,68.8,47,64.1,78,65.9,2,0
12/06/2017 20:20,30,68.8,46,64.2,76,66,2,0
12/06/2017 20:25,25,69,42,64.4,67,66.1,2,0
12/06/2017 20:30,28,69.2,44,64.6,72,66.4,2,0
12/06/2017 20:35,29,67.8,45,63.1,74,65,2,0
12/06/2017 20:40,30,67.9,47,63.2,77,65,2,0
12/06/2017 20:45,33,67.9,50,63.2,83,65.1,2,0
12/06/2017 20:50,26,67.9,42,63.1,68,64.9,2,0
12/06/2017 20:55,26,68.7,41,64,67,65.8,2,0
12/06/2017 21:00,26,68.8,42,64.2,68,65.9,2,0
12/06/2017 21:05,28,68.2,45,63.5,73,65.3,2,0
12/06/2017 21:10,27,68.7,42,64.1,69,65.9,2,0
12/06/2017 21:15,28,69.1,43,64.5,71,66.3,2,0
12/06/2017 21:20,25,69.1,40,64.4,65,66.2,2,0
12/06/2017 21:25,24,69.4,39,64.7,63,66.5,2,0
12/06/2017 21:30,25,68.5,41,63.9,66,65.6,2,0
12/06/2017 21:35,25,68.8,40,64.2,65,66,2,0
12/06/2017 21:40,32,68.3,49,63.6,81,65.4,2,0
12/06/2017 21:45,27,68.5,44,63.9,71,65.6,2,0
12/06/2017 21:50,22,69,39,64.4,61,66,2,0
12/06/2017 21:55,21,68.7,36,64.1,57,65.8,2,0
12/06/2017 22:00,24,68.8,39,64.2,63,66,2,0
12/06/2017 22:05,27,68.2,43,63.5,70,65.3,2,0
12/06/2017 22:10,16,68.9,32,64.2,48,65.8,2,0
12/06/2017 22:15,29,69,45,64.4,74,66.2,2,0
12/06/2017 22:20,22,69,38,64.4,60,66.1,2,0
12/06/2017 22:25,19,69.3,35,64.7,54,66.3,2,0
12/06/2017 22:30,23,69.3,38,64.7,61,66.5,2,0
12/06/2017 22:35,22,69.5,38,64.9,60,66.6,2,0
12/06/2017 22:40,23,69.5,39,64.9,62,66.6,2,0
12/06/2017 22:45,18,69.5,34,64.9,52,66.5,2,0
12/06/2017 22:50,22,69.4,38,64.8,60,66.5,2,0
12/06/2017 22:55,21,69.4,36,64.8,57,66.5,2,0
12/06/2017 23:00,19,69.1,35,64.4,54,66.1,2,0
12/06/2017 23:05,14,69.2,30,64.5,44,66,2,0
12/06/2017 23:10,15,69.4,31,64.8,46,66.3,2,0
12/06/2017 23:15,18,69.4,34,64.8,52,66.4,2,0
12/06/2017 23:20,17,69,33,64.4,50,66,2,0
12/06/2017 23:25,12,69.1,28,64.5,40,65.9,2,0
12/06/2017 23:30,16,69.2,31,64.6,47,66.2,2,0
12/06/2017 23:35,16,69.2,32,64.6,48,66.2,2,0
12/06/2017 23:40,15,69.2,30,64.6,45,66.1,2,0
12/06/2017 23:45,12,69.2,28,64.6,40,66,2,0
12/06/2017 23:50,12,69.3,28,64.7,40,66.1,2,0
12/06/2017 23:55,14,69.3,29,64.7,43,66.2,2,0
12/07/2017 0:00,11,69.3,26,64.7,37,66.1,2,0
12/07/2017 0:05,13,69.5,29,64.9,42,66.3,2,0
12/07/2017 0:10,12,69.6,27,65,39,66.4,2,0
12/07/2017 0:15,13,69.4,28,64.8,41,66.3,2,0
12/07/2017 0:20,12,69.4,27,64.8,39,66.3,2,0
12/07/2017 0:25,7,69.2,22,64.5,29,65.7,2,0
12/07/2017 0:30,10,69.1,25,64.5,35,65.8,2,0
12/07/2017 0:35,10,69.3,25,64.7,35,66,2,0
12/07/2017 0:40,9,69.4,24,64.8,33,66.1,2,0
12/07/2017 0:45,9,69.2,24,64.6,33,65.8,2,0
12/07/2017 0:50,7,69.3,22,64.7,29,65.8,2,0
12/07/2017 0:55,5,69.1,21,64.5,26,65.4,2,0
12/07/2017 1:00,6,69.2,21,64.5,27,65.6,2,0
12/07/2017 1:05,5,69.1,21,64.5,26,65.4,2,0
12/07/2017 1:10,5,69.3,20,64.7,25,65.7,2,0
12/07/2017 1:15,6,69.4,21,64.8,27,65.9,2,0
12/07/2017 1:20,7,69.4,22,64.8,29,65.9,2,0
12/07/2017 1:25,6,69.4,22,64.8,28,65.8,2,0
12/07/2017 1:30,6,69.4,21,64.8,27,65.8,2,0
12/07/2017 1:35,11,69.5,26,64.9,37,66.2,2,0
12/07/2017 1:40,7,69.4,22,64.8,29,65.9,2,0
12/07/2017 1:45,6,69.3,22,64.7,28,65.7,2,0
12/07/2017 1:50,10,69.4,20,64.7,30,66.3,2,0
12/07/2017 1:55,9,69.4,24,64.8,33,66,2,0
12/07/2017 2:00,7,69.3,22,64.7,29,65.8,2,0
12/07/2017 2:05,6,69.2,21,64.6,27,65.6,2,0
12/07/2017 2:10,7,69.2,23,64.6,30,65.7,2,0
12/07/2017 2:15,5,69.3,21,64.7,26,65.5,2,0
12/07/2017 2:20,8,69.3,23,64.7,31,65.9,2,0
12/07/2017 2:25,8,69.3,23,64.7,31,65.9,2,0
12/07/2017 2:30,9,69,24,64.4,33,65.6,2,0
12/07/2017 2:35,13,68.9,29,64.3,42,65.7,2,0
12/07/2017 2:40,7,69.1,22,64.5,29,65.6,2,0
12/07/2017 2:45,11,69.1,27,64.5,38,65.8,2,0
12/07/2017 2:50,8,69,23,64.4,31,65.6,2,0
12/07/2017 2:55,11,69.3,27,64.7,38,66,2,0
12/07/2017 3:00,8,69.1,24,64.4,32,65.6,2,0
12/07/2017 3:05,9,69,24,64.4,33,65.6,2,0
12/07/2017 3:10,11,68.9,26,64.3,37,65.7,2,0
12/07/2017 3:15,9,69.1,25,64.5,34,65.7,2,0
12/07/2017 3:20,11,69.1,27,64.5,38,65.8,2,0
12/07/2017 3:25,11,69.2,27,64.5,38,65.9,2,0
12/07/2017 3:30,13,69.2,28,64.5,41,66,2,0
12/07/2017 3:35,11,69,27,64.4,38,65.8,2,0
12/07/2017 3:40,12,69.2,28,64.6,40,66,2,0
12/07/2017 3:45,14,69.2,30,64.6,44,66.1,2,0
12/07/2017 3:50,12,69.3,28,64.7,40,66,2,0
12/07/2017 3:55,15,69,31,64.4,46,65.9,2,0
12/07/2017 4:00,13,69.2,28,64.6,41,66,2,0
12/07/2017 4:05,13,69.2,29,64.6,42,66,2,0
12/07/2017 4:10,22,68.9,39,64.2,61,65.9,2,0
12/07/2017 4:15,20,68.6,36,63.9,56,65.6,2,0
12/07/2017 4:20,22,68.8,39,64.2,61,65.8,2,0
12/07/2017 4:25,24,68.6,40,63.9,64,65.7,2,0
12/07/2017 4:30,26,69.1,43,64.4,69,66.2,2,0
12/07/2017 4:35,27,66.5,44,61.6,71,63.5,2,0
12/07/2017 4:40,32,67.7,50,63,82,64.9,2,0
12/07/2017 4:45,39,68.9,57,64.3,96,66.2,2,0
12/07/2017 4:50,40,68.2,58,63.6,98,65.5,2,0
12/07/2017 4:55,40,68.7,59,64,99,65.9,2,0
12/07/2017 5:00,35,69.1,53,64.5,88,66.3,2,0
12/07/2017 5:05,51,69.6,71,65,122,66.9,2,0
12/07/2017 5:10,35,69.2,52,64.5,87,66.4,2,0
12/07/2017 5:15,52,69.2,73,64.5,125,66.5,2,0
12/07/2017 5:20,51,68.6,71,63.8,122,65.8,2,0
12/07/2017 5:25,57,68.9,78,64.1,135,66.1,2,0
12/07/2017 5:30,60,68.6,82,63.9,142,65.9,2,0
12/07/2017 5:35,56,67.1,77,62.2,133,64.3,2,0
12/07/2017 5:40,70,66.5,93,61.6,163,63.7,2,0
12/07/2017 5:45,70,66.7,91,61.9,161,64,2,0
12/07/2017 5:50,61,68.1,83,63.3,144,65.4,2,0
12/07/2017 5:55,61,68.7,82,64,143,66,2,0
12/07/2017 6:00,56,69.1,76,64.4,132,66.4,2,0
12/07/2017 6:05,53,67.8,73,63.1,126,65.1,2,0
12/07/2017 6:10,52,67.1,73,62.3,125,64.3,2,0
12/07/2017 6:15,56,66.7,77,61.8,133,63.9,2,0
12/07/2017 6:20,67,67,89,62.1,156,64.2,2,0
12/07/2017 6:25,59,66.2,80,61.2,139,63.3,2,0
12/07/2017 6:30,70,65.9,92,61,162,63.1,2,0
12/07/2017 6:35,64,65.7,85,60.7,149,62.9,2,0
12/07/2017 6:40,69,66,91,61,160,63.2,2,0
12/07/2017 6:45,76,66.3,99,61.4,175,63.5,2,0
12/07/2017 6:50,66,66.5,88,61.6,154,63.7,2,0
12/07/2017 6:55,72,65.4,95,60.4,167,62.6,2,0
12/07/2017 7:00,59,65.4,80,60.3,139,62.4,2,0
12/07/2017 7:05,73,65.6,96,60.6,169,62.7,2,0
12/07/2017 7:10,74,65.6,95,60.6,169,62.8,2,0
12/07/2017 7:15,80,67.2,104,62.4,184,64.5,2,0
12/07/2017 7:20,82,67.5,106,62.7,188,64.8,2,0
12/07/2017 7:25,73,67.2,96,62.4,169,64.4,2,0
12/07/2017 7:30,77,67.9,99,63.2,176,65.3,2,0
12/07/2017 7:35,94,66.4,118,61.5,212,63.7,2,0
12/07/2017 7:40,88,66.6,113,61.7,201,63.8,2,0
12/07/2017 7:45,97,65.8,122,60.8,219,63,2,0
12/07/2017 7:50,91,66.6,116,61.7,207,63.9,2,0
12/07/2017 7:55,88,66.7,111,61.8,199,64,2,0
12/07/2017 8:00,73,66.3,95,61.4,168,63.5,2,0
12/07/2017 8:05,72,64.9,93,59.8,165,62.1,2,0
12/07/2017 8:10,83,65.2,106,60.1,189,62.3,2,0
12/07/2017 8:15,86,65.4,109,60.4,195,62.6,2,0
12/07/2017 8:20,78,65.2,100,60.1,178,62.4,2,0
12/07/2017 8:25,73,64.6,94,59.5,167,61.7,2,0
12/07/2017 8:30,72,65.1,93,60,165,62.2,2,0
12/07/2017 8:35,72,66.1,94,61,166,63.2,2,0
12/07/2017 8:40,79,65.8,101,60.8,180,63,2,0
12/07/2017 8:45,84,65.8,105,60.8,189,63,2,0
12/07/2017 8:50,76,65.6,97,60.6,173,62.8,2,0
12/07/2017 8:55,76,64.4,97,59.3,173,61.5,2,0
12/07/2017 9:00,85,64.2,107,59.1,192,61.4,2,0
12/07/2017 9:05,70,63.5,91,58.3,161,60.5,2,0
12/07/2017 9:10,72,64.4,94,59.3,166,61.5,2,0
12/07/2017 9:15,82,63.4,104,58.2,186,60.5,2,0
12/07/2017 9:20,66,64,87,58.9,153,61.1,2,0
12/07/2017 9:25,67,64.1,87,59,154,61.2,2,0
12/07/2017 9:30,75,64.8,96,59.8,171,62,2,0
12/07/2017 9:35,73,65.5,93,60.4,166,62.6,2,0
12/07/2017 9:40,74,65.4,95,60.4,169,62.6,2,0
12/07/2017 9:45,74,65.5,94,60.4,168,62.7,2,0
12/07/2017 9:50,65,65.3,85,60.2,150,62.4,2,0
12/07/2017 9:55,68,64.6,89,59.4,157,61.6,2,0
12/07/2017 10:00,72,64,94,58.9,166,61.1,2,0
12/07/2017 10:05,74,63.6,95,58.4,169,60.7,2,0
12/07/2017 10:10,57,63.8,75,58.6,132,60.9,2,0
12/07/2017 10:15,54,63.2,73,58,127,60.2,2,0
12/07/2017 10:20,56,65.2,75,60.1,131,62.3,2,0
12/07/2017 10:25,60,65.8,78,60.9,138,63,2,0
12/07/2017 10:30,54,65.4,73,60.5,127,62.6,2,0
12/07/2017 10:35,57,65,76,59.9,133,62.1,2,0
12/07/2017 10:40,60,63.7,79,58.6,139,60.8,2,0
12/07/2017 10:45,59,64.9,78,59.9,137,62.1,2,0
12/07/2017 10:50,54,66.3,72,61.4,126,63.5,2,0
12/07/2017 10:55,56,65.4,74,60.4,130,62.6,2,0
12/07/2017 11:00,48,65.6,66,60.6,114,62.7,2,0
12/07/2017 11:05,63,66.7,83,61.9,146,64,2,0
12/07/2017 11:10,57,65.2,76,60.2,133,62.4,2,0
12/07/2017 11:15,52,64.2,71,59.1,123,61.3,2,0
12/07/2017 11:20,64,65.1,83,60.2,147,62.3,2,0
12/07/2017 11:25,58,66.2,77,61.3,135,63.4,2,0
12/07/2017 11:30,63,66,81,61.1,144,63.2,2,0
12/07/2017 11:35,55,65.7,75,60.7,130,62.8,2,0
12/07/2017 11:40,59,65,78,60,137,62.2,2,0
12/07/2017 11:45,63,63.9,82,58.8,145,61,2,0
12/07/2017 11:50,61,64.2,81,59.1,142,61.3,2,0
12/07/2017 11:55,43,65.5,60,60.6,103,62.7,2,0
12/07/2017 12:00,54,66.2,72,61.3,126,63.4,2,0
12/07/2017 12:05,52,67.3,70,62.5,122,64.6,2,0
12/07/2017 12:10,52,66.9,70,62,122,64.1,2,0
12/07/2017 12:15,59,65.3,76,60.3,135,62.5,2,0
12/07/2017 12:20,46,66.1,64,61.2,110,63.3,2,0
12/07/2017 12:25,45,65.2,62,60.3,107,62.3,2,0
12/07/2017 12:30,50,66.6,68,61.8,118,63.8,2,0
12/07/2017 12:35,45,65.3,62,60.3,107,62.4,2,0
12/07/2017 12:40,48,66.4,66,61.5,114,63.6,2,0
12/07/2017 12:45,48,66.5,66,61.7,114,63.7,2,0
12/07/2017 12:50,53,66,72,61.1,125,63.2,2,0
12/07/2017 12:55,60,64.4,80,59.4,140,61.6,2,0
12/07/2017 13:00,54,65.5,72,60.6,126,62.7,2,0
12/07/2017 13:05,55,65.8,73,61,128,63.1,2,0
12/07/2017 13:10,51,65.9,69,61,120,63.1,2,0
12/07/2017 13:15,59,66.1,78,61.2,137,63.3,2,0
12/07/2017 13:20,44,65.8,62,60.9,106,62.9,2,0
12/07/2017 13:25,54,66.2,72,61.4,126,63.4,2,0
12/07/2017 13:30,52,65.5,70,60.5,122,62.6,2,0
12/07/2017 13:35,56,64,75,58.9,131,61.1,2,0
12/07/2017 13:40,48,65.2,65,60.2,113,62.3,2,0
12/07/2017 13:45,47,65,64,59.9,111,62.1,2,0
12/07/2017 13:50,46,65.8,63,60.9,109,63,2,0
12/07/2017 13:55,51,65.9,68,61,119,63.1,2,0
12/07/2017 14:00,47,66.1,64,61.2,111,63.3,2,0
12/07/2017 14:05,55,65.8,73,60.8,128,63,2,0
12/07/2017 14:10,48,65.7,66,60.7,114,62.8,2,0
12/07/2017 14:15,51,67,68,62.2,119,64.2,2,0
12/07/2017 14:20,45,65.9,63,61.1,108,63.1,2,0
12/07/2017 14:25,42,66,60,61.2,102,63.2,2,0
12/07/2017 14:30,56,64.9,74,59.9,130,62.1,2,0
12/07/2017 14:35,46,64.3,64,59.3,110,61.4,2,0
12/07/2017 14:40,56,65.9,74,61,130,63.1,2,0
12/07/2017 14:45,54,65.4,72,60.5,126,62.6,2,0
12/07/2017 14:50,52,64.6,70,59.6,122,61.8,2,0
12/07/2017 14:55,49,65.5,67,60.6,116,62.7,2,0
12/07/2017 15:00,50,65.5,67,60.6,117,62.7,2,0
12/07/2017 15:05,51,66.5,69,61.7,120,63.7,2,0
12/07/2017 15:10,62,65.8,80,60.9,142,63,2,0
12/07/2017 15:15,54,66.8,72,62,126,64,2,0
12/07/2017 15:20,56,67.2,75,62.5,131,64.5,2,0
12/07/2017 15:25,68,67,87,62.2,155,64.3,2,0
12/07/2017 15:30,61,67.1,79,62.3,140,64.4,2,0
12/07/2017 15:35,71,66.7,92,61.9,163,64,2,0
12/07/2017 15:40,76,66.8,96,62,172,64.1,2,0
12/07/2017 15:45,62,66.4,81,61.4,143,63.6,2,0
12/07/2017 15:50,57,67.2,74,62.3,131,64.4,2,0
12/07/2017 15:55,59,65.8,77,60.9,136,63.1,2,0
12/07/2017 16:00,59,65.1,78,60.1,137,62.2,2,0
12/07/2017 16:05,67,64.2,86,59,153,61.3,2,0
12/07/2017 16:10,55,63,74,57.7,129,59.9,2,0
12/07/2017 16:15,63,62.8,82,57.5,145,59.8,2,0
12/07/2017 16:20,52,64.8,71,59.7,123,61.9,2,0
12/07/2017 16:25,56,66.5,74,61.5,130,63.7,2,0
12/07/2017 16:30,54,66.8,72,61.9,126,64,2,0
12/07/2017 16:35,49,67,68,62.2,117,64.2,2,0
12/07/2017 16:40,49,65.8,68,60.7,117,62.9,2,0
12/07/2017 16:45,47,64.7,65,59.5,112,61.7,2,0
12/07/2017 16:50,45,64.1,63,59,108,61.2,2,0
12/07/2017 16:55,55,63,73,57.8,128,60,2,0
12/07/2017 17:00,45,64.8,62,59.7,107,61.9,2,0
12/07/2017 17:05,51,64.8,69,59.8,120,62,2,0
12/07/2017 17:10,53,65.3,72,60.4,125,62.5,2,0
12/07/2017 17:15,53,65.3,71,60.4,124,62.5,2,0
12/07/2017 17:20,52,66.4,70,61.6,122,63.7,2,0
12/07/2017 17:25,50,65.6,69,60.6,119,62.7,2,0
12/07/2017 17:30,51,65.9,69,60.9,120,63,2,0
12/07/2017 17:35,50,65.5,68,60.6,118,62.7,2,0
12/07/2017 17:40,59,64.5,78,59.5,137,61.6,2,0
12/07/2017 17:45,49,62.6,67,57.2,116,59.5,2,0
12/07/2017 17:50,45,63.8,64,58.6,109,60.8,2,0
12/07/2017 17:55,51,63.1,69,57.8,120,60.1,2,0
12/07/2017 18:00,45,62.6,63,57.2,108,59.4,2,0
12/07/2017 18:05,52,64.3,71,59.2,123,61.4,2,0
12/07/2017 18:10,54,66.1,71,61.1,125,63.3,2,0
12/07/2017 18:15,49,65.7,67,60.8,116,62.8,2,0
12/07/2017 18:20,49,65.7,68,60.9,117,62.9,2,0
12/07/2017 18:25,51,66,69,61.1,120,63.2,2,0
12/07/2017 18:30,46,66,64,61.1,110,63.1,2,0
12/07/2017 18:35,51,67.3,69,62.5,120,64.5,2,0
12/07/2017 18:40,41,67.6,58,62.8,99,64.8,2,0
12/07/2017 18:45,44,67.1,61,62.3,105,64.3,2,0
12/07/2017 18:50,42,67.3,59,62.5,101,64.5,2,0
12/07/2017 18:55,45,67.6,62,62.8,107,64.8,2,0
12/07/2017 19:00,34,67.6,51,62.8,85,64.7,2,0
12/07/2017 19:05,41,66.9,59,62.1,100,64.1,2,0
12/07/2017 19:10,40,66.7,58,61.9,98,63.8,2,0
12/07/2017 19:15,44,67.7,61,63,105,64.9,2,0
12/07/2017 19:20,38,68.8,55,64.2,93,66.1,2,0
12/07/2017 19:25,43,66.4,60,61.5,103,63.6,2,0
12/07/2017 19:30,48,66.8,65,62,113,64,2,0
12/07/2017 19:35,44,67.1,61,62.2,105,64.3,2,0
12/07/2017 19:40,34,67.1,52,62.2,86,64.2,2,0
12/07/2017 19:45,34,67.4,51,62.5,85,64.5,2,0
12/07/2017 19:50,40,67.9,57,63.2,97,65.1,2,0
12/07/2017 19:55,45,68.5,62,63.8,107,65.8,2,0
12/07/2017 20:00,34,69.1,51,64.5,85,66.4,2,0
12/07/2017 20:05,36,69,52,64.3,88,66.2,2,0
12/07/2017 20:10,42,67.5,59,62.8,101,64.7,2,0
12/07/2017 20:15,31,66.5,49,61.8,80,63.6,2,0
12/07/2017 20:20,31,67.3,47,62.6,78,64.5,2,0
12/07/2017 20:25,30,68.1,46,63.4,76,65.2,2,0
12/07/2017 20:30,30,68.2,46,63.5,76,65.4,2,0
12/07/2017 20:35,33,68.8,49,64.2,82,66,2,0
12/07/2017 20:40,28,69.2,45,64.5,73,66.3,2,0
12/07/2017 20:45,34,69.8,50,65.2,84,67.1,2,0
12/07/2017 20:50,23,69.4,39,64.8,62,66.5,2,0
12/07/2017 20:55,36,69.1,53,64.5,89,66.4,2,0
12/07/2017 21:00,30,68.8,47,64.1,77,66,2,0
12/07/2017 21:05,28,69.4,44,64.8,72,66.6,2,0
12/07/2017 21:10,32,69.4,47,64.7,79,66.6,2,0
12/07/2017 21:15,29,68.2,45,63.5,74,65.4,2,0
12/07/2017 21:20,26,69,42,64.4,68,66.1,2,0
12/07/2017 21:25,19,69.4,34,64.8,53,66.4,2,0
12/07/2017 21:30,25,69.4,42,64.8,67,66.5,2,0
12/07/2017 21:35,26,69.5,43,64.9,69,66.6,2,0
12/07/2017 21:40,23,69.4,40,64.8,63,66.5,2,0
12/07/2017 21:45,24,69.6,41,65,65,66.7,2,0
12/07/2017 21:50,30,69.8,47,65.2,77,67,2,0
12/07/2017 21:55,24,69.4,39,64.8,63,66.6,2,0
12/07/2017 22:00,33,69,49,64.4,82,66.3,2,0
12/07/2017 22:05,24,68.6,40,64,64,65.7,2,0
12/07/2017 22:10,26,69,42,64.4,68,66.1,2,0
12/07/2017 22:15,27,69,43,64.4,70,66.2,2,0
12/07/2017 22:20,22,68.6,38,64,60,65.7,2,0
12/07/2017 22:25,26,68.9,42,64.3,68,66,2,0
12/07/2017 22:30,24,69.1,39,64.5,63,66.3,2,0
12/07/2017 22:35,26,68.9,42,64.2,68,66,2,0
12/07/2017 22:40,19,69,34,64.4,53,66,2,0
12/07/2017 22:45,19,69.2,34,64.6,53,66.3,2,0
12/07/2017 22:50,17,69.3,33,64.7,50,66.3,2,0
12/07/2017 22:55,14,69.3,30,64.7,44,66.2,2,0
12/07/2017 23:00,13,69.1,28,64.5,41,66,2,0
12/07/2017 23:05,13,69.3,28,64.7,41,66.1,2,0
12/07/2017 23:10,14,68.8,29,64.2,43,65.7,2,0
12/07/2017 23:15,17,69,33,64.3,50,65.9,2,0
12/07/2017 23:20,13,69.2,29,64.5,42,66,2,0
12/07/2017 23:25,15,69.2,31,64.5,46,66.1,2,0
12/07/2017 23:30,15,69.3,30,64.7,45,66.2,2,0
12/07/2017 23:35,16,69.3,31,64.7,47,66.2,2,0
12/07/2017 23:40,15,68.8,30,64.1,45,65.7,2,0
12/07/2017 23:45,14,68.8,29,64.1,43,65.6,2,0
12/07/2017 23:50,11,69.1,27,64.4,38,65.8,2,0
12/07/2017 23:55,12,68.9,26,64.2,38,65.7,2,0
12/08/2017 0:00,10,69.3,25,64.7,35,66.1,2,0
12/08/2017 0:05,17,69.6,32,65,49,66.6,2,0
12/08/2017 0:10,12,69.3,27,64.7,39,66.1,2,0
12/08/2017 0:15,12,69.2,27,64.6,39,66,2,0
12/08/2017 0:20,8,69.2,24,64.6,32,65.7,2,0
12/08/2017 0:25,7,69.2,22,64.6,29,65.7,2,0
12/08/2017 0:30,10,69.3,25,64.7,35,66.1,2,0
12/08/2017 0:35,10,69.4,25,64.8,35,66.1,2,0
12/08/2017 0:40,10,69.4,25,64.8,35,66.1,2,0
12/08/2017 0:45,7,69.4,22,64.8,29,65.9,2,0
12/08/2017 0:50,9,69.4,24,64.8,33,66.1,2,0
12/08/2017 0:55,8,69.4,24,64.8,32,65.9,2,0
12/08/2017 1:00,7,69.4,22,64.8,29,66,2,0
12/08/2017 1:05,16,69.2,23,64.6,39,66.5,2,0
12/08/2017 1:10,12,69.3,21,64.7,33,66.4,2,0
12/08/2017 1:15,9,69.4,24,64.8,33,66.1,2,0
12/08/2017 1:20,8,69.4,24,64.8,32,66,2,0
12/08/2017 1:25,8,69.4,23,64.8,31,66,2,0
12/08/2017 1:30,10,69.4,26,64.8,36,66.1,2,0
12/08/2017 1:35,10,69.3,26,64.7,36,66,2,0
12/08/2017 1:40,8,69.4,24,64.8,32,65.9,2,0
12/08/2017 1:45,9,69.4,19,64.8,28,66.3,2,0
12/08/2017 1:50,8,69.5,23,64.9,31,66.1,2,0
12/08/2017 1:55,8,69.5,23,64.9,31,66.1,2,0
12/08/2017 2:00,8,69.5,23,64.9,31,66.1,2,0
12/08/2017 2:05,15,69.4,22,64.8,37,66.7,2,0
12/08/2017 2:10,7,69.2,22,64.6,29,65.7,2,0
12/08/2017 2:15,10,69.2,25,64.6,35,65.9,2,0
12/08/2017 2:20,6,69.2,22,64.6,28,65.6,2,0
12/08/2017 2:25,5,69.2,21,64.6,26,65.5,2,0
12/08/2017 2:30,9,69.3,24,64.7,33,66,2,0
12/08/2017 2:35,8,69.4,23,64.8,31,66,2,0
12/08/2017 2:40,7,69.2,22,64.5,29,65.6,2,0
12/08/2017 2:45,12,69.2,27,64.6,39,66,2,0
12/08/2017 2:50,20,69.3,25,64.7,45,66.8,2,0
12/08/2017 2:55,8,69.3,23,64.7,31,65.9,2,0
12/08/2017 3:00,10,69.2,26,64.6,36,65.8,2,0
12/08/2017 3:05,11,68.9,26,64.3,37,65.7,2,0
12/08/2017 3:10,8,69.1,24,64.5,32,65.6,2,0
12/08/2017 3:15,10,69,25,64.3,35,65.6,2,0
12/08/2017 3:20,14,68.8,29,64.2,43,65.7,2,0
12/08/2017 3:25,12,69.1,28,64.5,40,65.8,2,0
12/08/2017 3:30,12,69.2,27,64.6,39,66,2,0
12/08/2017 3:35,15,69.4,31,64.8,46,66.3,2,0
12/08/2017 3:40,12,69.4,28,64.8,40,66.2,2,0
12/08/2017 3:45,13,69.5,28,64.9,41,66.3,2,0
12/08/2017 3:50,14,69.3,30,64.6,44,66.1,2,0
12/08/2017 3:55,17,69.2,33,64.6,50,66.2,2,0
12/08/2017 4:00,14,69.3,30,64.6,44,66.1,2,0
12/08/2017 4:05,15,69.3,31,64.7,46,66.2,2,0
12/08/2017 4:10,17,69,33,64.4,50,66,2,0
12/08/2017 4:15,20,69.2,37,64.6,57,66.2,2,0
12/08/2017 4:20,23,69.2,39,64.6,62,66.3,2,0
12/08/2017 4:25,23,69.1,39,64.5,62,66.2,2,0
12/08/2017 4:30,19,69,35,64.4,54,66,2,0
12/08/2017 4:35,30,68.8,47,64.1,77,65.9,2,0
12/08/2017 4:40,32,68.9,49,64.2,81,66.1,2,0
12/08/2017 4:45,42,68.6,61,63.8,103,65.7,2,0
12/08/2017 4:50,30,68.9,47,64.2,77,66,2,0
12/08/2017 4:55,30,69.3,48,64.7,78,66.4,2,0
12/08/2017 5:00,36,69.4,54,64.8,90,66.6,2,0
12/08/2017 5:05,40,69.7,58,65.1,98,67,2,0
12/08/2017 5:10,41,67.7,60,62.9,101,64.9,2,0
12/08/2017 5:15,50,69.2,69,64.5,119,66.5,2,0
12/08/2017 5:20,57,70.1,78,65.5,135,67.4,2,0
12/08/2017 5:25,45,69.3,65,64.6,110,66.5,2,0
12/08/2017 5:30,51,69.2,70,64.4,121,66.4,2,0
12/08/2017 5:35,52,67.1,72,62.2,124,64.3,2,0
12/08/2017 5:40,65,67.2,86,62.4,151,64.5,2,0
12/08/2017 5:45,68,67.7,90,62.9,158,65,2,0
12/08/2017 5:50,55,67.2,75,62.3,130,64.4,2,0
12/08/2017 5:55,61,67.8,83,62.9,144,64.9,2,0
12/08/2017 6:00,59,67.3,79,62.4,138,64.5,2,0
12/08/2017 6:05,63,67.6,84,62.7,147,64.8,2,0
12/08/2017 6:10,65,66.3,87,61.2,152,63.4,2,0
12/08/2017 6:15,58,66.2,80,61.2,138,63.3,2,0
12/08/2017 6:20,62,66.3,83,61.3,145,63.4,2,0
12/08/2017 6:25,58,67.2,79,62.4,137,64.5,2,0
12/08/2017 6:30,64,65.7,85,60.7,149,62.9,2,0
12/08/2017 6:35,62,65.8,83,60.8,145,62.9,2,0
12/08/2017 6:40,72,65.7,94,60.7,166,62.9,2,0
12/08/2017 6:45,63,65.6,85,60.6,148,62.8,2,0
12/08/2017 6:50,68,67.8,90,63,158,65.1,2,0
12/08/2017 6:55,66,68.3,88,63.5,154,65.6,2,0
12/08/2017 7:00,74,67.5,96,62.7,170,64.8,2,0
12/08/2017 7:05,81,67.3,104,62.5,185,64.6,2,0
12/08/2017 7:10,81,66.8,104,61.9,185,64,2,0
12/08/2017 7:15,82,66,106,61,188,63.2,2,0
12/08/2017 7:20,90,66.3,113,61.4,203,63.6,2,0
12/08/2017 7:25,87,66.8,110,61.9,197,64.1,2,0
12/08/2017 7:30,76,67.9,98,63.1,174,65.2,2,0
12/08/2017 7:35,88,67,112,62.2,200,64.3,2,0
12/08/2017 7:40,92,66.7,116,61.9,208,64,2,0
12/08/2017 7:45,83,66.8,106,61.9,189,64.1,2,0
12/08/2017 7:50,87,67.1,110,62.2,197,64.4,2,0
12/08/2017 7:55,81,68.1,104,63.3,185,65.4,2,0
12/08/2017 8:00,68,68.2,89,63.4,157,65.5,2,0
12/08/2017 8:05,72,68.1,93,63.4,165,65.5,2,0
12/08/2017 8:10,73,67.6,95,62.8,168,64.9,2,0
12/08/2017 8:15,82,65.7,105,60.8,187,63,2,0
12/08/2017 8:20,80,66.4,101,61.5,181,63.7,2,0
12/08/2017 8:25,71,67.1,93,62.2,164,64.3,2,0
12/08/2017 8:30,75,65.6,97,60.7,172,62.8,2,0
12/08/2017 8:35,74,65.8,96,60.8,170,63,2,0
12/08/2017 8:40,86,66.1,109,61.2,195,63.4,2,0
12/08/2017 8:45,68,67.1,89,62.3,157,64.4,2,0
12/08/2017 8:50,73,66.4,94,61.6,167,63.7,2,0
12/08/2017 8:55,70,66.8,90,62,160,64.1,2,0
12/08/2017 9:00,69,67.1,89,62.3,158,64.4,2,0
12/08/2017 9:05,72,65.8,94,60.9,166,63,2,0
12/08/2017 9:10,64,67.3,84,62.4,148,64.5,2,0
12/08/2017 9:15,62,66.9,81,62.1,143,64.2,2,0
12/08/2017 9:20,59,66.9,77,62.1,136,64.2,2,0
12/08/2017 9:25,51,66.7,70,61.9,121,63.9,2,0
12/08/2017 9:30,69,66.1,89,61.2,158,63.3,2,0
12/08/2017 9:35,59,65.8,78,60.9,137,63,2,0
12/08/2017 9:40,72,67.1,93,62.2,165,64.3,2,0
12/08/2017 9:45,65,67,85,62.1,150,64.2,2,0
12/08/2017 9:50,71,66.8,91,62,162,64.1,2,0
12/08/2017 9:55,64,65,83,60,147,62.2,2,0
12/08/2017 10:00,60,65.9,79,61,139,63.1,2,0
12/08/2017 10:05,55,67,73,62.2,128,64.3,2,0
12/08/2017 10:10,60,66.3,79,61.5,139,63.5,2,0
12/08/2017 10:15,62,65.6,82,60.7,144,62.8,2,0
12/08/2017 10:20,60,67.1,79,62.3,139,64.4,2,0
12/08/2017 10:25,57,67.1,77,62.3,134,64.4,2,0
12/08/2017 10:30,60,68.3,79,63.6,139,65.6,2,0
12/08/2017 10:35,64,67.8,84,63,148,65.1,2,0
12/08/2017 10:40,59,67.5,78,62.8,137,64.9,2,0
12/08/2017 10:45,63,68.4,82,63.7,145,65.8,2,0
12/08/2017 10:50,64,68.7,83,64.1,147,66.1,2,0
12/08/2017 10:55,59,67.9,79,63.2,138,65.2,2,0
12/08/2017 11:00,52,66.9,70,62,122,64.1,2,0
12/08/2017 11:05,58,68.6,76,64,134,66,2,0
12/08/2017 11:10,54,67.5,72,62.7,126,64.8,2,0
12/08/2017 11:15,57,68.2,76,63.5,133,65.5,2,0
12/08/2017 11:20,54,68.4,72,63.7,126,65.8,2,0
12/08/2017 11:25,64,67.9,84,63.2,148,65.2,2,0
12/08/2017 11:30,55,67.4,74,62.7,129,64.7,2,0
12/08/2017 11:35,62,67.6,80,62.8,142,64.9,2,0
12/08/2017 11:40,54,69.2,71,64.6,125,66.6,2,0
12/08/2017 11:45,67,68.4,85,63.7,152,65.8,2,0
12/08/2017 11:50,64,66.9,83,62.1,147,64.2,2,0
12/08/2017 11:55,58,67.9,76,63.2,134,65.2,2,0
12/08/2017 12:00,66,67.3,84,62.5,150,64.6,2,0
12/08/2017 12:05,56,69.2,74,64.5,130,66.5,2,0
12/08/2017 12:10,60,69,79,64.3,139,66.3,2,0
12/08/2017 12:15,53,68,71,63.2,124,65.2,2,0
12/08/2017 12:20,59,66.9,77,62.1,136,64.1,2,0
12/08/2017 12:25,55,67,73,62.1,128,64.2,2,0
12/08/2017 12:30,54,68.5,72,63.9,126,65.9,2,0
12/08/2017 12:35,58,67.3,76,62.6,134,64.6,2,0
12/08/2017 12:40,49,66.8,68,61.9,117,63.9,2,0
12/08/2017 12:45,56,66.4,73,61.5,129,63.6,2,0
12/08/2017 12:50,56,67.5,74,62.8,130,64.8,2,0
12/08/2017 12:55,51,68.3,69,63.6,120,65.6,2,0
12/08/2017 13:00,52,67.1,70,62.3,122,64.4,2,0
12/08/2017 13:05,42,67.4,60,62.7,102,64.6,2,0
12/08/2017 13:10,59,66.4,77,61.5,136,63.6,2,0
12/08/2017 13:15,57,66.7,74,61.9,131,64,2,0
12/08/2017 13:20,50,66.9,67,62.2,117,64.2,2,0
12/08/2017 13:25,56,67,75,62.3,131,64.3,2,0
12/08/2017 13:30,54,67.5,72,62.8,126,64.8,2,0
12/08/2017 13:35,52,67.1,70,62.3,122,64.3,2,0
12/08/2017 13:40,52,67.9,70,63.1,122,65.2,2,0
12/08/2017 13:45,52,68.8,70,64.2,122,66.1,2,0
12/08/2017 13:50,53,68.2,71,63.5,124,65.5,2,0
12/08/2017 13:55,49,68.2,66,63.5,115,65.5,2,0
12/08/2017 14:00,48,67.8,65,63.1,113,65.1,2,0
12/08/2017 14:05,48,68.2,66,63.6,114,65.5,2,0
12/08/2017 14:10,48,68.4,66,63.7,114,65.7,2,0
12/08/2017 14:15,53,69.2,70,64.6,123,66.6,2,0
12/08/2017 14:20,57,69,76,64.3,133,66.3,2,0
12/08/2017 14:25,46,68.1,64,63.3,110,65.3,2,0
12/08/2017 14:30,52,67.4,69,62.6,121,64.7,2,0
12/08/2017 14:35,54,68.7,71,64.1,125,66.1,2,0
12/08/2017 14:40,58,68.7,76,63.9,134,66,2,0
12/08/2017 14:45,51,68.5,68,63.7,119,65.8,2,0
12/08/2017 14:50,57,67.1,76,62.2,133,64.3,2,0
12/08/2017 14:55,46,67.2,63,62.3,109,64.4,2,0
12/08/2017 15:00,43,67.3,61,62.6,104,64.5,2,0
12/08/2017 15:05,43,68.3,60,63.6,103,65.6,2,0
12/08/2017 15:10,51,67.7,68,63,119,65,2,0
12/08/2017 15:15,48,68.2,66,63.5,114,65.5,2,0
12/08/2017 15:20,55,65.5,73,60.6,128,62.7,2,0
12/08/2017 15:25,59,67,78,62.2,137,64.3,2,0
12/08/2017 15:30,65,66.7,85,61.9,150,64,2,0
12/08/2017 15:35,68,66.3,88,61.4,156,63.5,2,0
12/08/2017 15:40,72,67.6,91,62.7,163,64.9,2,0
12/08/2017 15:45,63,67.4,82,62.5,145,64.6,2,0
12/08/2017 15:50,68,67.8,88,63,156,65.1,2,0
12/08/2017 15:55,66,67.9,85,63.1,151,65.2,2,0
12/08/2017 16:00,65,66.5,84,61.6,149,63.8,2,0
12/08/2017 16:05,66,66.3,86,61.4,152,63.5,2,0
12/08/2017 16:10,48,66.4,67,61.5,115,63.6,2,0
12/08/2017 16:15,53,66.8,71,62,124,64,2,0
12/08/2017 16:20,61,66.8,80,62,141,64.1,2,0
12/08/2017 16:25,50,67,68,62.2,118,64.2,2,0
12/08/2017 16:30,58,68.2,77,63.4,135,65.5,2,0
12/08/2017 16:35,57,67.2,76,62.3,133,64.4,2,0
12/08/2017 16:40,61,66.6,80,61.7,141,63.8,2,0
12/08/2017 16:45,60,66.9,78,62,138,64.1,2,0
12/08/2017 16:50,55,65.9,74,61,129,63.1,2,0
12/08/2017 16:55,52,64.8,71,59.8,123,61.9,2,0
12/08/2017 17:00,50,65.3,69,60.4,119,62.4,2,0
12/08/2017 17:05,51,66.1,69,61.1,120,63.2,2,0
12/08/2017 17:10,51,67.3,70,62.5,121,64.5,2,0
12/08/2017 17:15,53,67.3,71,62.5,124,64.5,2,0
12/08/2017 17:20,63,66,83,61,146,63.1,2,0
12/08/2017 17:25,52,65.4,70,60.3,122,62.4,2,0
12/08/2017 17:30,55,64.6,73,59.3,128,61.6,2,0
12/08/2017 17:35,51,63.6,69,58.3,120,60.6,2,0
12/08/2017 17:40,57,65,76,59.9,133,62.1,2,0
12/08/2017 17:45,57,65.1,76,59.9,133,62.1,2,0
12/08/2017 17:50,49,66.1,67,61,116,63.2,2,0
12/08/2017 17:55,54,66.9,73,62,127,64.1,2,0
12/08/2017 18:00,50,66.4,68,61.5,118,63.6,2,0
12/08/2017 18:05,49,66.8,67,62,116,64,2,0
12/08/2017 18:10,47,67.4,65,62.6,112,64.6,2,0
12/08/2017 18:15,62,65.3,81,60.2,143,62.4,2,0
12/08/2017 18:20,60,65.4,78,60.3,138,62.5,2,0
12/08/2017 18:25,62,64.2,82,59.1,144,61.3,2,0
12/08/2017 18:30,57,65.5,75,60.5,132,62.7,2,0
12/08/2017 18:35,55,66.4,73,61.5,128,63.6,2,0
12/08/2017 18:40,47,67.4,66,62.5,113,64.5,2,0
12/08/2017 18:45,48,67.8,66,63,114,65,2,0
12/08/2017 18:50,42,68.7,58,64.1,100,66,2,0
12/08/2017 18:55,47,66.8,65,61.9,112,63.9,2,0
12/08/2017 19:00,52,67.4,71,62.5,123,64.6,2,0
12/08/2017 19:05,56,66.8,74,61.9,130,64,2,0
12/08/2017 19:10,47,67.1,65,62.3,112,64.3,2,0
12/08/2017 19:15,42,67.7,59,63,101,65,2,0
12/08/2017 19:20,44,68.1,60,63.4,104,65.4,2,0
12/08/2017 19:25,44,67.6,62,62.8,106,64.8,2,0
12/08/2017 19:30,53,66.6,71,61.7,124,63.8,2,0
12/08/2017 19:35,45,67,63,62.2,108,64.2,2,0
12/08/2017 19:40,49,67.2,67,62.4,116,64.4,2,0
12/08/2017 19:45,43,68.2,61,63.5,104,65.4,2,0
12/08/2017 19:50,38,68.6,55,63.9,93,65.8,2,0
12/08/2017 19:55,33,68.4,49,63.7,82,65.6,2,0
12/08/2017 20:00,35,68.4,51,63.7,86,65.6,2,0
12/08/2017 20:05,46,68.6,63,63.8,109,65.8,2,0
12/08/2017 20:10,35,68.5,52,63.8,87,65.7,2,0
12/08/2017 20:15,35,69.1,51,64.4,86,66.3,2,0
12/08/2017 20:20,35,69.4,52,64.8,87,66.7,2,0
12/08/2017 20:25,34,68.9,50,64.3,84,66.1,2,0
12/08/2017 20:30,28,69.2,44,64.6,72,66.4,2,0
12/08/2017 20:35,34,69,50,64.4,84,66.3,2,0
12/08/2017 20:40,37,67.2,53,62.5,90,64.4,2,0
12/08/2017 20:45,38,67.8,54,63.1,92,65,2,0
12/08/2017 20:50,34,68.4,50,63.7,84,65.6,2,0
12/08/2017 20:55,37,68.8,54,64.2,91,66,2,0
12/08/2017 21:00,33,68.3,50,63.6,83,65.5,2,0
12/08/2017 21:05,33,68.5,49,63.9,82,65.8,2,0
12/08/2017 21:10,34,69,50,64.4,84,66.2,2,0
12/08/2017 21:15,32,68.1,49,63.4,81,65.3,2,0
12/08/2017 21:20,31,68.3,47,63.7,78,65.5,2,0
12/08/2017 21:25,29,68.9,46,64.3,75,66.1,2,0
12/08/2017 21:30,32,68.6,48,63.9,80,65.8,2,0
12/08/2017 21:35,29,68.8,44,64.1,73,66,2,0
12/08/2017 21:40,28,68.1,44,63.4,72,65.3,2,0
12/08/2017 21:45,34,68.7,51,64,85,65.9,2,0
12/08/2017 21:50,32,68.8,49,64.1,81,65.9,2,0
12/08/2017 21:55,30,68.5,46,63.8,76,65.6,2,0
12/08/2017 22:00,28,69,44,64.4,72,66.2,2,0
12/08/2017 22:05,31,69.1,47,64.4,78,66.3,2,0
12/08/2017 22:10,32,68.6,50,63.9,82,65.7,2,0
12/08/2017 22:15,25,68.7,41,64.1,66,65.8,2,0
12/08/2017 22:20,25,69.1,41,64.4,66,66.2,2,0
12/08/2017 22:25,28,69.2,44,64.6,72,66.4,2,0
12/08/2017 22:30,26,69.4,42,64.8,68,66.6,2,0
12/08/2017 22:35,32,68.8,48,64.1,80,66,2,0
12/08/2017 22:40,22,69.2,38,64.6,60,66.3,2,0
12/08/2017 22:45,22,68.7,39,64,61,65.7,2,0
12/08/2017 22:50,24,69.1,40,64.5,64,66.2,2,0
12/08/2017 22:55,26,69.3,42,64.7,68,66.4,2,0
12/08/2017 23:00,21,69.4,37,64.8,58,66.4,2,0
12/08/2017 23:05,26,69.2,42,64.5,68,66.3,2,0
12/08/2017 23:10,29,69.3,44,64.6,73,66.5,2,0
12/08/2017 23:15,22,69.2,38,64.5,60,66.2,2,0
12/08/2017 23:20,22,68.9,38,64.2,60,65.9,2,0
12/08/2017 23:25,16,69.1,32,64.5,48,66,2,0
12/08/2017 23:30,16,69.2,32,64.6,48,66.2,2,0
12/08/2017 23:35,20,69.3,36,64.7,56,66.3,2,0
12/08/2017 23:40,16,69.4,32,64.8,48,66.3,2,0
12/08/2017 23:45,20,69.4,35,64.8,55,66.5,2,0
12/08/2017 23:50,15,69.3,30,64.7,45,66.2,2,0
12/08/2017 23:55,18,69,33,64.4,51,66,2,0
12/09/2017 0:00,19,69.3,34,64.7,53,66.4,2,0
12/09/2017 0:05,15,69.4,30,64.8,45,66.3,2,0
12/09/2017 0:10,19,69.4,35,64.8,54,66.4,2,0
12/09/2017 0:15,13,69.4,28,64.8,41,66.3,2,0
12/09/2017 0:20,11,69.4,26,64.8,37,66.2,2,0
12/09/2017 0:25,14,69.4,29,64.8,43,66.3,2,0
12/09/2017 0:30,12,69,27,64.4,39,65.8,2,0
12/09/2017 0:35,15,69.2,30,64.5,45,66.1,2,0
12/09/2017 0:40,16,68.8,32,64.1,48,65.7,2,0
12/09/2017 0:45,11,69.1,26,64.5,37,65.8,2,0
12/09/2017 0:50,13,69.2,29,64.6,42,66,2,0
12/09/2017 0:55,10,69.2,25,64.6,35,65.9,2,0
12/09/2017 1:00,11,69.3,26,64.7,37,66.1,2,0
12/09/2017 1:05,10,69.4,25,64.8,35,66.1,2,0
12/09/2017 1:10,10,69.4,25,64.8,35,66.1,2,0
12/09/2017 1:15,10,69.3,26,64.7,36,65.9,2,0
12/09/2017 1:20,14,68.8,30,64.1,44,65.6,2,0
12/09/2017 1:25,11,68.8,27,64.2,38,65.5,2,0
12/09/2017 1:30,9,69,24,64.4,33,65.6,2,0
12/09/2017 1:35,14,69.2,29,64.5,43,66,2,0
12/09/2017 1:40,8,69.1,23,64.4,31,65.6,2,0
12/09/2017 1:45,7,69.3,23,64.7,30,65.7,2,0
12/09/2017 1:50,10,69.3,25,64.7,35,66,2,0
12/09/2017 1:55,8,69.3,23,64.7,31,65.9,2,0
12/09/2017 2:00,10,69.4,25,64.8,35,66.1,2,0
12/09/2017 2:05,10,69.1,25,64.5,35,65.8,2,0
12/09/2017 2:10,10,69.2,25,64.6,35,65.9,2,0
12/09/2017 2:15,11,69.3,26,64.7,37,66.1,2,0
12/09/2017 2:20,10,69.4,26,64.8,36,66.1,2,0
12/09/2017 2:25,10,69.3,25,64.7,35,66,2,0
12/09/2017 2:30,9,69.4,24,64.7,33,66,2,0
12/09/2017 2:35,11,69.4,26,64.7,37,66.1,2,0
12/09/2017 2:40,8,69.4,23,64.8,31,66,2,0
12/09/2017 2:45,9,69.4,24,64.8,33,66.1,2,0
12/09/2017 2:50,7,69.4,23,64.8,30,65.8,2,0
12/09/2017 2:55,8,69.2,23,64.5,31,65.7,2,0
12/09/2017 3:00,10,69.2,26,64.6,36,65.9,2,0
12/09/2017 3:05,8,69.2,23,64.6,31,65.8,2,0
12/09/2017 3:10,7,69.3,22,64.7,29,65.8,2,0
12/09/2017 3:15,7,69.3,23,64.7,30,65.8,2,0
12/09/2017 3:20,8,69.3,24,64.7,32,65.9,2,0
12/09/2017 3:25,10,69.4,25,64.8,35,66.1,2,0
12/09/2017 3:30,9,69.1,25,64.5,34,65.7,2,0
12/09/2017 3:35,9,69.2,25,64.6,34,65.8,2,0
12/09/2017 3:40,10,69.4,25,64.8,35,66.1,2,0
12/09/2017 3:45,11,69.4,27,64.8,38,66.1,2,0
12/09/2017 3:50,9,69.3,25,64.7,34,66,2,0
12/09/2017 3:55,9,69.3,24,64.7,33,66,2,0
12/09/2017 4:00,6,69.4,21,64.8,27,65.8,2,0
12/09/2017 4:05,11,69.3,27,64.7,38,66,2,0
12/09/2017 4:10,8,69.2,24,64.6,32,65.7,2,0
12/09/2017 4:15,11,69.2,27,64.6,38,66,2,0
12/09/2017 4:20,15,68.8,30,64.1,45,65.7,2,0
12/09/2017 4:25,11,69,26,64.4,37,65.8,2,0
12/09/2017 4:30,13,69.2,29,64.5,42,66,2,0
12/09/2017 4:35,16,69.3,32,64.7,48,66.2,2,0
12/09/2017 4:40,10,69.3,26,64.7,36,65.9,2,0
12/09/2017 4:45,14,69.2,30,64.6,44,66.1,2,0
12/09/2017 4:50,13,69.2,29,64.6,42,66.1,2,0
12/09/2017 4:55,15,69.2,31,64.6,46,66.1,2,0
12/09/2017 5:00,20,68.6,36,63.9,56,65.6,2,0
12/09/2017 5:05,14,68.9,30,64.3,44,65.8,2,0
12/09/2017 5:10,18,69,34,64.4,52,66,2,0
12/09/2017 5:15,17,68.8,33,64.1,50,65.7,2,0
12/09/2017 5:20,16,68.9,32,64.3,48,65.8,2,0
12/09/2017 5:25,20,68.9,36,64.3,56,65.9,2,0
12/09/2017 5:30,19,68.9,35,64.3,54,65.9,2,0
12/09/2017 5:35,17,69.1,33,64.5,50,66,2,0
12/09/2017 5:40,26,69.3,43,64.7,69,66.5,2,0
12/09/2017 5:45,18,69.3,34,64.6,52,66.2,2,0
12/09/2017 5:50,21,69.4,38,64.8,59,66.4,2,0
12/09/2017 5:55,22,68.9,38,64.2,60,65.9,2,0
12/09/2017 6:00,21,69,37,64.4,58,66.1,2,0
12/09/2017 6:05,24,68.7,40,64,64,65.8,2,0
12/09/2017 6:10,24,69.2,40,64.5,64,66.3,2,0
12/09/2017 6:15,26,69.4,43,64.8,69,66.6,2,0
12/09/2017 6:20,21,69.2,37,64.6,58,66.3,2,0
12/09/2017 6:25,19,69.1,36,64.5,55,66.1,2,0
12/09/2017 6:30,23,69.1,39,64.4,62,66.2,2,0
12/09/2017 6:35,28,68.9,45,64.2,73,66,2,0
12/09/2017 6:40,25,69.1,42,64.5,67,66.2,2,0
12/09/2017 6:45,30,69,47,64.4,77,66.2,2,0
12/09/2017 6:50,25,68.7,41,64,66,65.8,2,0
12/09/2017 6:55,20,69.1,36,64.5,56,66.2,2,0
12/09/2017 7:00,26,69.3,42,64.7,68,66.4,2,0
12/09/2017 7:05,24,69.2,41,64.6,65,66.3,2,0
12/09/2017 7:10,24,69.4,41,64.7,65,66.4,2,0
12/09/2017 7:15,30,68.6,47,63.9,77,65.7,2,0
12/09/2017 7:20,35,69.7,51,65.1,86,67,2,0
12/09/2017 7:25,43,69.5,61,65,104,66.8,2,0
12/09/2017 7:30,30,69.8,46,65.2,76,67,2,0
12/09/2017 7:35,44,69.1,60,64.5,104,66.4,2,0
12/09/2017 7:40,41,69,57,64.4,98,66.3,2,0
12/09/2017 7:45,53,68.6,70,63.9,123,66,2,0
12/09/2017 7:50,40,68.9,58,64.3,98,66.2,2,0
12/09/2017 7:55,34,69.8,51,65.2,85,67.1,2,0
12/09/2017 8:00,35,69.4,52,64.8,87,66.7,2,0
12/09/2017 8:05,39,70,56,65.4,95,67.3,2,0
12/09/2017 8:10,37,70.3,53,65.7,90,67.6,2,0
12/09/2017 8:15,41,70.1,58,65.5,99,67.4,2,0
12/09/2017 8:20,42,69.7,59,65.2,101,67.1,2,0
12/09/2017 8:25,43,69.2,60,64.6,103,66.5,2,0
12/09/2017 8:30,40,69.2,57,64.6,97,66.5,2,0
12/09/2017 8:35,50,69,68,64.3,118,66.2,2,0
12/09/2017 8:40,56,68.7,75,64,131,66,2,0
12/09/2017 8:45,54,69,73,64.3,127,66.3,2,0
12/09/2017 8:50,45,69.2,63,64.5,108,66.5,2,0
12/09/2017 8:55,56,68.6,74,63.8,130,65.9,2,0
12/09/2017 9:00,47,70,66,65.4,113,67.3,2,0
12/09/2017 9:05,47,70.1,65,65.6,112,67.5,2,0
12/09/2017 9:10,49,68.5,67,63.8,116,65.8,2,0
12/09/2017 9:15,61,68.4,79,63.7,140,65.8,2,0
12/09/2017 9:20,54,69,72,64.3,126,66.3,2,0
12/09/2017 9:25,56,68.4,74,63.8,130,65.8,2,0
12/09/2017 9:30,62,68.2,79,63.5,141,65.5,2,0
12/09/2017 9:35,53,68.4,71,63.7,124,65.7,2,0
12/09/2017 9:40,51,69,69,64.3,120,66.3,2,0
12/09/2017 9:45,62,68.7,81,64,143,66.1,2,0
12/09/2017 9:50,66,69.2,84,64.6,150,66.6,2,0
12/09/2017 9:55,63,69.5,81,64.8,144,66.8,2,0
12/09/2017 10:00,55,69.6,73,64.9,128,66.9,2,0
12/09/2017 10:05,69,68.9,89,64.2,158,66.2,2,0
12/09/2017 10:10,68,69.2,89,64.5,157,66.5,2,0
12/09/2017 10:15,57,69.4,76,64.9,133,66.8,2,0
12/09/2017 10:20,56,69.9,76,65.3,132,67.3,2,0
12/09/2017 10:25,60,69.2,79,64.6,139,66.6,2,0
12/09/2017 10:30,69,68.7,88,64,157,66,2,0
12/09/2017 10:35,59,68,77,63.2,136,65.2,2,0
12/09/2017 10:40,65,68.1,83,63.3,148,65.4,2,0
12/09/2017 10:45,57,67.8,76,62.9,133,65,2,0
12/09/2017 10:50,59,68,77,63.2,136,65.3,2,0
12/09/2017 10:55,67,69.2,86,64.5,153,66.5,2,0
12/09/2017 11:00,58,67.6,76,62.7,134,64.8,2,0
12/09/2017 11:05,65,67.9,83,63.1,148,65.2,2,0
12/09/2017 11:10,69,68.5,90,63.9,159,65.9,2,0
12/09/2017 11:15,64,68.3,82,63.6,146,65.7,2,0
12/09/2017 11:20,73,67.9,94,63.2,167,65.3,2,0
12/09/2017 11:25,56,69.1,75,64.5,131,66.5,2,0
12/09/2017 11:30,71,68.7,92,64.1,163,66.1,2,0
12/09/2017 11:35,68,68,87,63.2,155,65.3,2,0
12/09/2017 11:40,63,68.1,81,63.4,144,65.5,2,0
12/09/2017 11:45,65,68.6,84,63.9,149,65.9,2,0
12/09/2017 11:50,64,68,83,63.2,147,65.3,2,0
12/09/2017 11:55,63,68.5,82,63.8,145,65.9,2,0
12/09/2017 12:00,65,68.6,84,63.9,149,65.9,2,0
12/09/2017 12:05,62,68.8,81,64.2,143,66.2,2,0
12/09/2017 12:10,59,68.9,77,64.2,136,66.2,2,0
12/09/2017 12:15,65,69.2,84,64.6,149,66.6,2,0
12/09/2017 12:20,52,69.1,70,64.5,122,66.5,2,0
12/09/2017 12:25,58,69.1,77,64.5,135,66.4,2,0
12/09/2017 12:30,65,68.8,83,64.2,148,66.2,2,0
12/09/2017 12:35,72,68.8,91,64.2,163,66.2,2,0
12/09/2017 12:40,63,67.7,81,63,144,65.1,2,0
12/09/2017 12:45,67,67.9,86,63.2,153,65.3,2,0
12/09/2017 12:50,62,68.3,82,63.6,144,65.6,2,0
12/09/2017 12:55,64,68.6,84,63.9,148,65.9,2,0
12/09/2017 13:00,62,68.3,81,63.6,143,65.7,2,0
12/09/2017 13:05,67,67.9,87,63.1,154,65.1,2,0
12/09/2017 13:10,57,67.5,75,62.6,132,64.7,2,0
12/09/2017 13:15,67,67.5,86,62.7,153,64.8,2,0
12/09/2017 13:20,58,67.5,76,62.7,134,64.8,2,0
12/09/2017 13:25,64,69,82,64.3,146,66.4,2,0
12/09/2017 13:30,61,67.8,79,63.1,140,65.2,2,0
12/09/2017 13:35,62,68.1,80,63.4,142,65.5,2,0
12/09/2017 13:40,62,68.7,81,64,143,66,2,0
12/09/2017 13:45,60,68.8,79,64.1,139,66.1,2,0
12/09/2017 13:50,68,68.5,86,63.8,154,65.9,2,0
12/09/2017 13:55,64,68.8,83,64.1,147,66.2,2,0
12/09/2017 14:00,51,69,69,64.3,120,66.3,2,0
12/09/2017 14:05,58,68.7,75,64,133,66.1,2,0
12/09/2017 14:10,67,68.7,87,63.9,154,66,2,0
12/09/2017 14:15,58,68.6,77,63.8,135,65.9,2,0
12/09/2017 14:20,61,67.8,78,62.9,139,65.1,2,0
12/09/2017 14:25,68,67.7,87,62.8,155,64.9,2,0
12/09/2017 14:30,57,67.5,74,62.6,131,64.7,2,0
12/09/2017 14:35,64,68,83,63.2,147,65.3,2,0
12/09/2017 14:40,57,68.3,75,63.5,132,65.6,2,0
12/09/2017 14:45,64,68.4,84,63.7,148,65.7,2,0
12/09/2017 14:50,56,68.6,74,63.9,130,65.9,2,0
12/09/2017 14:55,60,67.6,79,62.8,139,64.8,2,0
12/09/2017 15:00,53,68.2,70,63.4,123,65.4,2,0
12/09/2017 15:05,56,68.7,74,64,130,66,2,0
12/09/2017 15:10,56,68.3,76,63.6,132,65.6,2,0
12/09/2017 15:15,57,69.1,75,64.5,132,66.5,2,0
12/09/2017 15:20,64,68,83,63.2,147,65.3,2,0
12/09/2017 15:25,75,67.7,95,62.9,170,65,2,0
12/09/2017 15:30,60,66.9,79,62,139,64.1,2,0
12/09/2017 15:35,67,67.9,87,63.2,154,65.2,2,0
12/09/2017 15:40,70,67.8,91,63,161,65.1,2,0
12/09/2017 15:45,69,67.8,89,63,158,65.1,2,0
12/09/2017 15:50,63,68,81,63.2,144,65.3,2,0
12/09/2017 15:55,62,67.2,82,62.2,144,64.4,2,0
12/09/2017 16:00,47,68.3,65,63.5,112,65.5,2,0
12/09/2017 16:05,57,67.6,75,62.9,132,64.9,2,0
12/09/2017 16:10,47,68.3,64,63.7,111,65.6,2,0
12/09/2017 16:15,59,68.7,78,64.1,137,66.1,2,0
12/09/2017 16:20,53,68.8,71,64.2,124,66.2,2,0
12/09/2017 16:25,55,68.3,73,63.6,128,65.6,2,0
12/09/2017 16:30,65,67.4,84,62.7,149,64.8,2,0
12/09/2017 16:35,57,67.6,75,62.9,132,64.9,2,0
12/09/2017 16:40,62,68.1,81,63.3,143,65.4,2,0
12/09/2017 16:45,66,67.5,84,62.7,150,64.8,2,0
12/09/2017 16:50,72,66.8,92,61.9,164,64.1,2,0
12/09/2017 16:55,62,67,81,62.2,143,64.3,2,0
12/09/2017 17:00,61,65.9,79,60.9,140,63.1,2,0
12/09/2017 17:05,60,64,77,58.9,137,61.1,2,0
12/09/2017 17:10,55,62.6,72,57.3,127,59.6,2,0
12/09/2017 17:15,56,62.3,72,56.9,128,59.2,2,0
12/09/2017 17:20,57,64.4,75,59.3,132,61.5,2,0
12/09/2017 17:25,62,65.6,81,60.6,143,62.8,2,0
12/09/2017 17:30,64,65.8,83,60.9,147,63,2,0
12/09/2017 17:35,67,65.9,87,60.9,154,63.1,2,0
12/09/2017 17:40,67,66.3,86,61.3,153,63.5,2,0
12/09/2017 17:45,63,66.7,83,61.9,146,64,2,0
12/09/2017 17:50,65,67,84,62.2,149,64.3,2,0
12/09/2017 17:55,65,66.8,84,61.9,149,64.1,2,0
12/09/2017 18:00,71,68.4,90,63.7,161,65.8,2,0
12/09/2017 18:05,61,68.7,80,64,141,66,2,0
12/09/2017 18:10,67,68.9,87,64.3,154,66.3,2,0
12/09/2017 18:15,58,68.5,77,63.9,135,65.9,2,0
12/09/2017 18:20,67,68.5,86,63.9,153,65.9,2,0
12/09/2017 18:25,64,68.4,83,63.7,147,65.7,2,0
12/09/2017 18:30,54,68.9,72,64.2,126,66.2,2,0
12/09/2017 18:35,64,68.8,82,64.1,146,66.1,2,0
12/09/2017 18:40,61,69.2,80,64.6,141,66.6,2,0
12/09/2017 18:45,59,68.8,78,64.1,137,66.2,2,0
12/09/2017 18:50,61,69.1,80,64.5,141,66.5,2,0
12/09/2017 18:55,56,70,74,65.5,130,67.4,2,0
12/09/2017 19:00,54,69,72,64.4,126,66.4,2,0
12/09/2017 19:05,56,68.1,75,63.4,131,65.4,2,0
12/09/2017 19:10,60,68.3,78,63.6,138,65.7,2,0
12/09/2017 19:15,53,67.3,72,62.5,125,64.5,2,0
12/09/2017 19:20,50,68.6,67,63.9,117,65.9,2,0
12/09/2017 19:25,50,67.5,67,62.7,117,64.7,2,0
12/09/2017 19:30,53,67.7,72,63,125,65,2,0
12/09/2017 19:35,41,68.2,57,63.5,98,65.4,2,0
12/09/2017 19:40,42,69,59,64.4,101,66.3,2,0
12/09/2017 19:45,40,69.2,57,64.6,97,66.5,2,0
12/09/2017 19:50,39,69.1,56,64.5,95,66.4,2,0
12/09/2017 19:55,37,68.7,54,64,91,65.9,2,0
12/09/2017 20:00,43,69.2,60,64.6,103,66.5,2,0
12/09/2017 20:05,36,68.3,52,63.6,88,65.5,2,0
12/09/2017 20:10,32,68.6,49,63.9,81,65.8,2,0
12/09/2017 20:15,34,68.9,50,64.2,84,66.1,2,0
12/09/2017 20:20,26,68.9,42,64.3,68,66.1,2,0
12/09/2017 20:25,31,68.2,47,63.6,78,65.4,2,0
12/09/2017 20:30,38,69.2,55,64.6,93,66.5,2,0
12/09/2017 20:35,32,69.2,48,64.6,80,66.5,2,0
12/09/2017 20:40,35,69.6,50,65,85,66.9,2,0
12/09/2017 20:45,27,69.6,43,65,70,66.8,2,0
12/09/2017 20:50,33,69.5,50,64.9,83,66.8,2,0
12/09/2017 20:55,32,69.6,48,65,80,66.8,2,0
12/09/2017 21:00,29,69.4,45,64.8,74,66.6,2,0
12/09/2017 21:05,29,69.3,46,64.7,75,66.4,2,0
12/09/2017 21:10,29,69.3,45,64.7,74,66.5,2,0
12/09/2017 21:15,34,70,50,65.4,84,67.2,2,0
12/09/2017 21:20,37,70,53,65.5,90,67.3,2,0
12/09/2017 21:25,31,69.7,46,65.1,77,67,2,0
12/09/2017 21:30,36,69,53,64.3,89,66.2,2,0
12/09/2017 21:35,35,68.7,52,64,87,65.9,2,0
12/09/2017 21:40,33,68.9,50,64.2,83,66.1,2,0
12/09/2017 21:45,37,68.8,54,64.1,91,66.1,2,0
12/09/2017 21:50,33,68.6,49,63.9,82,65.8,2,0
12/09/2017 21:55,29,69,45,64.4,74,66.2,2,0
12/09/2017 22:00,33,69.1,50,64.4,83,66.3,2,0
12/09/2017 22:05,33,68.8,49,64.1,82,66,2,0
12/09/2017 22:10,32,68.8,48,64.2,80,66.1,2,0
12/09/2017 22:15,27,68.9,43,64.2,70,66,2,0
12/09/2017 22:20,31,69,46,64.4,77,66.2,2,0
12/09/2017 22:25,37,68.7,53,64.1,90,66,2,0
12/09/2017 22:30,32,69.6,48,65,80,66.8,2,0
12/09/2017 22:35,29,69.2,45,64.6,74,66.4,2,0
12/09/2017 22:40,28,68.7,44,64,72,65.9,2,0
12/09/2017 22:45,31,68.9,48,64.2,79,66.1,2,0
12/09/2017 22:50,22,69,38,64.3,60,66,2,0
12/09/2017 22:55,23,69.3,39,64.7,62,66.4,2,0
12/09/2017 23:00,19,69.1,34,64.5,53,66.1,2,0
12/09/2017 23:05,29,69.2,45,64.6,74,66.4,2,0
12/09/2017 23:10,28,68.8,44,64.2,72,66,2,0
12/09/2017 23:15,21,69.2,36,64.6,57,66.3,2,0
12/09/2017 23:20,26,69.3,42,64.7,68,66.5,2,0
12/09/2017 23:25,22,69.5,37,64.9,59,66.6,2,0
12/09/2017 23:30,24,69.4,39,64.8,63,66.6,2,0
12/09/2017 23:35,22,69.6,37,65,59,66.7,2,0
12/09/2017 23:40,19,69.2,34,64.6,53,66.3,2,0
12/09/2017 23:45,20,68.5,36,63.8,56,65.5,2,0
12/09/2017 23:50,24,68.9,39,64.2,63,66,2,0
12/09/2017 23:55,19,68.8,35,64.2,54,65.8,2,0
12/10/2017 0:00,22,69.3,38,64.7,60,66.4,2,0
12/10/2017 0:05,16,69.2,32,64.5,48,66.1,2,0
12/10/2017 0:10,18,69.3,33,64.7,51,66.3,2,0
12/10/2017 0:15,18,69.3,33,64.7,51,66.3,2,0
12/10/2017 0:20,18,69.3,32,64.7,50,66.3,2,0
12/10/2017 0:25,14,69.2,30,64.5,44,66,2,0
12/10/2017 0:30,14,69.1,30,64.5,44,66,2,0
12/10/2017 0:35,11,69.2,26,64.6,37,66,2,0
12/10/2017 0:40,16,69.3,31,64.7,47,66.2,2,0
12/10/2017 0:45,15,69,30,64.4,45,65.9,2,0
12/10/2017 0:50,12,69.2,27,64.6,39,66,2,0
12/10/2017 0:55,13,69.2,29,64.6,42,66,2,0
12/10/2017 1:00,12,69.4,26,64.8,38,66.2,2,0
12/10/2017 1:05,10,69.4,25,64.8,35,66.1,2,0
12/10/2017 1:10,9,69.3,24,64.7,33,66,2,0
12/10/2017 1:15,12,69.2,27,64.6,39,66,2,0
12/10/2017 1:20,12,69.4,27,64.8,39,66.2,2,0
12/10/2017 1:25,11,69.4,27,64.8,38,66.2,2,0
12/10/2017 1:30,19,69.4,24,64.8,43,66.9,2,0
12/10/2017 1:35,9,69.4,25,64.8,34,66.1,2,0
12/10/2017 1:40,8,69.4,23,64.8,31,66,2,0
12/10/2017 1:45,15,69.4,22,64.8,37,66.6,2,0
12/10/2017 1:50,9,69.3,24,64.7,33,66,2,0
12/10/2017 1:55,8,69.4,23,64.8,31,66,2,0
12/10/2017 2:00,8,69.3,24,64.7,32,65.9,2,0
12/10/2017 2:05,10,69.3,25,64.7,35,66,2,0
12/10/2017 2:10,8,69.2,23,64.6,31,65.8,2,0
12/10/2017 2:15,7,69.3,22,64.7,29,65.8,2,0
12/10/2017 2:20,8,69.4,24,64.8,32,65.9,2,0
12/10/2017 2:25,10,69.4,25,64.8,35,66.1,2,0
12/10/2017 2:30,6,69.2,21,64.6,27,65.6,2,0
12/10/2017 2:35,12,69.3,27,64.7,39,66.2,2,0
12/10/2017 2:40,8,69.3,23,64.7,31,65.8,2,0
12/10/2017 2:45,9,69.3,24,64.7,33,66,2,0
12/10/2017 2:50,9,69.3,24,64.7,33,66,2,0
12/10/2017 2:55,6,69.4,22,64.8,28,65.8,2,0
12/10/2017 3:00,8,69.4,23,64.7,31,65.9,2,0
12/10/2017 3:05,8,69.4,24,64.7,32,65.9,2,0
12/10/2017 3:10,7,69.3,22,64.7,29,65.8,2,0
12/10/2017 3:15,11,69.3,27,64.7,38,66,2,0
12/10/2017 3:20,8,69.3,23,64.7,31,65.9,2,0
12/10/2017 3:25,8,69.3,23,64.7,31,65.9,2,0
12/10/2017 3:30,16,69.3,23,64.7,39,66.6,2,0
12/10/2017 3:35,7,69.3,23,64.7,30,65.8,2,0
12/10/2017 3:40,9,69.3,24,64.7,33,65.9,2,0
12/10/2017 3:45,6,69.3,21,64.7,27,65.7,2,0
12/10/2017 3:50,5,69.3,21,64.7,26,65.6,2,0
12/10/2017 3:55,5,69.3,21,64.7,26,65.6,2,0
12/10/2017 4:00,6,69.4,21,64.8,27,65.8,2,0
12/10/2017 4:05,8,69.3,24,64.7,32,65.9,2,0
12/10/2017 4:10,8,69.3,24,64.7,32,65.9,2,0
12/10/2017 4:15,6,69.3,22,64.7,28,65.7,2,0
12/10/2017 4:20,11,69.2,26,64.6,37,66,2,0
12/10/2017 4:25,10,69.3,26,64.7,36,65.9,2,0
12/10/2017 4:30,8,69.1,23,64.5,31,65.7,2,0
12/10/2017 4:35,9,69.2,24,64.6,33,65.9,2,0
12/10/2017 4:40,13,69.2,28,64.5,41,66,2,0
12/10/2017 4:45,8,69.3,24,64.7,32,65.8,2,0
12/10/2017 4:50,7,69.3,22,64.7,29,65.8,2,0
12/10/2017 4:55,12,69.4,27,64.8,39,66.2,2,0
12/10/2017 5:00,10,69.3,26,64.7,36,66,2,0
12/10/2017 5:05,12,69.4,27,64.7,39,66.2,2,0
12/10/2017 5:10,10,69.3,25,64.7,35,66,2,0
12/10/2017 5:15,9,69.4,24,64.8,33,66.1,2,0
12/10/2017 5:20,14,69.4,30,64.8,44,66.3,2,0
12/10/2017 5:25,14,69.3,29,64.7,43,66.2,2,0
12/10/2017 5:30,14,69.2,30,64.5,44,66,2,0
12/10/2017 5:35,13,69.1,29,64.5,42,65.9,2,0
12/10/2017 5:40,14,69.3,30,64.7,44,66.1,2,0
12/10/2017 5:45,16,69.4,32,64.8,48,66.3,2,0
12/10/2017 5:50,10,69.3,25,64.7,35,66.1,2,0
12/10/2017 5:55,9,69.3,24,64.7,33,66,2,0
12/10/2017 6:00,12,69.4,27,64.8,39,66.2,2,0
12/10/2017 6:05,14,69.3,29,64.7,43,66.2,2,0
12/10/2017 6:10,13,69.3,29,64.7,42,66.2,2,0
12/10/2017 6:15,10,69.3,25,64.7,35,66,2,0
12/10/2017 6:20,17,69.2,33,64.6,50,66.2,2,0
12/10/2017 6:25,16,69.2,32,64.6,48,66.1,2,0
12/10/2017 6:30,15,69.2,31,64.6,46,66.1,2,0
12/10/2017 6:35,19,69.4,34,64.8,53,66.4,2,0
12/10/2017 6:40,22,69.5,38,64.9,60,66.6,2,0
12/10/2017 6:45,16,69.3,32,64.7,48,66.2,2,0
12/10/2017 6:50,18,69.4,33,64.8,51,66.4,2,0
12/10/2017 6:55,19,69.5,34,64.9,53,66.5,2,0
12/10/2017 7:00,20,69.4,35,64.8,55,66.5,2,0
12/10/2017 7:05,23,69.5,39,64.9,62,66.6,2,0
12/10/2017 7:10,17,69.3,33,64.7,50,66.3,2,0
12/10/2017 7:15,21,69,37,64.4,58,66.1,2,0
12/10/2017 7:20,20,69.2,36,64.6,56,66.2,2,0
12/10/2017 7:25,21,69.2,37,64.6,58,66.3,2,0
12/10/2017 7:30,24,69.3,40,64.7,64,66.4,2,0
12/10/2017 7:35,27,69.5,43,65,70,66.7,2,0
12/10/2017 7:40,31,69.7,48,65.1,79,66.9,2,0
12/10/2017 7:45,28,69.6,44,65.1,72,66.9,2,0
12/10/2017 7:50,31,69.2,47,64.6,78,66.4,2,0
12/10/2017 7:55,24,69.3,40,64.7,64,66.4,2,0
12/10/2017 8:00,30,69.7,47,65.1,77,66.9,2,0
12/10/2017 8:05,22,69.5,38,64.9,60,66.6,2,0
12/10/2017 8:10,24,69.4,40,64.8,64,66.5,2,0
12/10/2017 8:15,25,69.2,41,64.6,66,66.4,2,0
12/10/2017 8:20,34,69.3,51,64.7,85,66.5,2,0
12/10/2017 8:25,33,69.6,50,65,83,66.8,2,0
12/10/2017 8:30,27,69.5,42,64.9,69,66.7,2,0
12/10/2017 8:35,28,69.2,45,64.6,73,66.3,2,0
12/10/2017 8:40,26,69.1,42,64.4,68,66.2,2,0
12/10/2017 8:45,36,69.4,52,64.8,88,66.7,2,0
12/10/2017 8:50,36,69.3,52,64.7,88,66.6,2,0
12/10/2017 8:55,37,69.9,54,65.3,91,67.2,2,0
12/10/2017 9:00,35,69.9,51,65.3,86,67.2,2,0
12/10/2017 9:05,32,69.9,49,65.4,81,67.2,2,0
12/10/2017 9:10,31,69.5,47,64.9,78,66.7,2,0
12/10/2017 9:15,37,69.9,54,65.3,91,67.2,2,0
12/10/2017 9:20,36,69.6,53,65,89,66.9,2,0
12/10/2017 9:25,35,69.8,51,65.2,86,67,2,0
12/10/2017 9:30,42,69.5,59,64.9,101,66.8,2,0
12/10/2017 9:35,40,69.6,57,65,97,66.9,2,0
12/10/2017 9:40,44,69.1,61,64.4,105,66.4,2,0
12/10/2017 9:45,49,69.5,66,64.8,115,66.8,2,0
12/10/2017 9:50,44,69.8,60,65.2,104,67.1,2,0
12/10/2017 9:55,54,68.8,71,64,125,66.1,2,0
12/10/2017 10:00,48,68.3,65,63.6,113,65.6,2,0
12/10/2017 10:05,48,69,65,64.3,113,66.3,2,0
12/10/2017 10:10,42,69,60,64.3,102,66.2,2,0
12/10/2017 10:15,44,69.8,61,65.2,105,67.1,2,0
12/10/2017 10:20,60,69.5,78,64.9,138,66.9,2,0
12/10/2017 10:25,48,69.9,65,65.3,113,67.3,2,0
12/10/2017 10:30,52,69.3,69,64.7,121,66.7,2,0
12/10/2017 10:35,52,68.6,70,63.9,122,65.9,2,0
12/10/2017 10:40,50,69.2,67,64.6,117,66.5,2,0
12/10/2017 10:45,48,69.3,67,64.6,115,66.5,2,0
12/10/2017 10:50,49,70.1,66,65.5,115,67.5,2,0
12/10/2017 10:55,56,69,73,64.4,129,66.4,2,0
12/10/2017 11:00,39,68.7,57,64,96,65.9,2,0
12/10/2017 11:05,48,68.6,65,63.9,113,65.9,2,0
12/10/2017 11:10,51,68.7,67,64.1,118,66.1,2,0
12/10/2017 11:15,58,69.2,76,64.6,134,66.6,2,0
12/10/2017 11:20,49,69.6,66,65,115,67,2,0
12/10/2017 11:25,47,68.3,64,63.7,111,65.6,2,0
12/10/2017 11:30,48,68.6,66,63.9,114,65.9,2,0
12/10/2017 11:35,52,68.4,69,63.8,121,65.8,2,0
12/10/2017 11:40,54,68.9,71,64.2,125,66.2,2,0
12/10/2017 11:45,57,68.9,74,64.3,131,66.3,2,0
12/10/2017 11:50,51,69.1,69,64.5,120,66.4,2,0
12/10/2017 11:55,53,69.1,70,64.5,123,66.5,2,0
12/10/2017 12:00,56,69.7,73,65.1,129,67.1,2,0
12/10/2017 12:05,52,69.2,69,64.6,121,66.6,2,0
12/10/2017 12:10,47,69.5,65,65,112,66.9,2,0
12/10/2017 12:15,44,69.5,61,64.9,105,66.8,2,0
12/10/2017 12:20,56,69.6,75,65,131,66.9,2,0
12/10/2017 12:25,53,69.9,70,65.3,123,67.3,2,0
12/10/2017 12:30,54,69.4,73,64.8,127,66.8,2,0
12/10/2017 12:35,59,69.9,77,65.4,136,67.3,2,0
12/10/2017 12:40,52,69.2,70,64.7,122,66.6,2,0
12/10/2017 12:45,60,68.4,79,63.7,139,65.7,2,0
12/10/2017 12:50,61,68.1,79,63.4,140,65.4,2,0
12/10/2017 12:55,59,68.7,76,64.1,135,66.1,2,0
12/10/2017 13:00,55,68.5,72,63.8,127,65.9,2,0
12/10/2017 13:05,60,68.7,79,64,139,66,2,0
12/10/2017 13:10,54,69.3,72,64.7,126,66.7,2,0
12/10/2017 13:15,52,68.4,70,63.8,122,65.7,2,0
12/10/2017 13:20,57,67.6,75,62.9,132,64.9,2,0
12/10/2017 13:25,59,68.1,78,63.3,137,65.4,2,0
12/10/2017 13:30,56,68.2,74,63.5,130,65.6,2,0
12/10/2017 13:35,59,69.1,77,64.4,136,66.4,2,0
12/10/2017 13:40,52,68.5,71,63.9,123,65.8,2,0
12/10/2017 13:45,51,68.8,68,64.2,119,66.2,2,0
12/10/2017 13:50,52,69.3,70,64.7,122,66.7,2,0
12/10/2017 13:55,56,69.2,74,64.6,130,66.6,2,0
12/10/2017 14:00,46,69.8,63,65.3,109,67.2,2,0
12/10/2017 14:05,58,69.7,76,65.2,134,67.2,2,0
12/10/2017 14:10,50,70,68,65.5,118,67.4,2,0
12/10/2017 14:15,59,69.1,78,64.5,137,66.5,2,0
12/10/2017 14:20,53,69.4,71,64.8,124,66.8,2,0
12/10/2017 14:25,63,69.1,81,64.4,144,66.5,2,0
12/10/2017 14:30,62,69,81,64.3,143,66.3,2,0
12/10/2017 14:35,57,69.3,74,64.7,131,66.7,2,0
12/10/2017 14:40,60,68.2,79,63.5,139,65.5,2,0
12/10/2017 14:45,63,69.2,81,64.6,144,66.6,2,0
12/10/2017 14:50,62,69.3,80,64.7,142,66.7,2,0
12/10/2017 14:55,58,69.6,76,65.1,134,67.1,2,0
12/10/2017 15:00,49,69.6,68,65,117,66.9,2,0
12/10/2017 15:05,58,69.8,76,65.3,134,67.3,2,0
12/10/2017 15:10,53,69.6,71,65,124,67,2,0
12/10/2017 15:15,60,69.6,79,65,139,67,2,0
12/10/2017 15:20,52,70.3,70,65.8,122,67.7,2,0
12/10/2017 15:25,61,70,80,65.5,141,67.4,2,0
12/10/2017 15:30,58,69.4,77,64.8,135,66.8,2,0
12/10/2017 15:35,63,69.3,82,64.6,145,66.6,2,0
12/10/2017 15:40,59,69.8,77,65.2,136,67.2,2,0
12/10/2017 15:45,55,69.5,73,65,128,66.9,2,0
12/10/2017 15:50,56,70,73,65.5,129,67.4,2,0
12/10/2017 15:55,64,68.8,83,64.2,147,66.2,2,0
12/10/2017 16:00,48,68.3,67,63.7,115,65.6,2,0
12/10/2017 16:05,56,69.4,73,64.9,129,66.8,2,0
12/10/2017 16:10,49,68.5,67,63.9,116,65.8,2,0
12/10/2017 16:15,64,68.8,83,64.2,147,66.2,2,0
12/10/2017 16:20,54,69.2,72,64.6,126,66.6,2,0
12/10/2017 16:25,58,69.5,76,64.9,134,66.9,2,0
12/10/2017 16:30,59,69,77,64.4,136,66.4,2,0
12/10/2017 16:35,65,69.3,84,64.7,149,66.7,2,0
12/10/2017 16:40,55,69.4,73,64.9,128,66.8,2,0
12/10/2017 16:45,52,69.6,70,65.1,122,67,2,0
12/10/2017 16:50,62,69.8,81,65.3,143,67.3,2,0
12/10/2017 16:55,49,69.7,67,65.2,116,67.1,2,0
12/10/2017 17:00,52,70,70,65.5,122,67.4,2,0
12/10/2017 17:05,48,69.5,66,65,114,66.9,2,0
12/10/2017 17:10,56,69.5,74,64.9,130,66.9,2,0
12/10/2017 17:15,49,69.2,66,64.7,115,66.6,2,0
12/10/2017 17:20,58,67.5,76,62.7,134,64.8,2,0
12/10/2017 17:25,47,67.9,63,63.2,110,65.2,2,0
12/10/2017 17:30,55,68.1,73,63.3,128,65.4,2,0
12/10/2017 17:35,63,67.7,82,63,145,65,2,0
12/10/2017 17:40,58,67.8,76,63.1,134,65.1,2,0
12/10/2017 17:45,57,68.5,74,63.8,131,65.8,2,0
12/10/2017 17:50,66,68.2,84,63.5,150,65.6,2,0
12/10/2017 17:55,45,69,62,64.4,107,66.3,2,0
12/10/2017 18:00,51,69.4,69,64.8,120,66.7,2,0
12/10/2017 18:05,56,68.4,73,63.8,129,65.8,2,0
12/10/2017 18:10,47,68.1,64,63.4,111,65.4,2,0
12/10/2017 18:15,51,69.4,69,64.8,120,66.8,2,0
12/10/2017 18:20,51,69.2,69,64.6,120,66.5,2,0
12/10/2017 18:25,51,67.9,69,63.1,120,65.2,2,0
12/10/2017 18:30,48,68.3,66,63.6,114,65.6,2,0
12/10/2017 18:35,45,69.4,63,64.8,108,66.7,2,0
12/10/2017 18:40,48,69.1,65,64.4,113,66.4,2,0
12/10/2017 18:45,52,69.1,70,64.5,122,66.5,2,0
12/10/2017 18:50,40,68.8,56,64.2,96,66.1,2,0
12/10/2017 18:55,51,68.8,68,64.1,119,66.1,2,0
12/10/2017 19:00,38,69.1,55,64.4,93,66.3,2,0
12/10/2017 19:05,40,69.2,57,64.6,97,66.5,2,0
12/10/2017 19:10,39,68.1,56,63.5,95,65.4,2,0
12/10/2017 19:15,41,68.9,57,64.3,98,66.2,2,0
12/10/2017 19:20,39,68.2,56,63.5,95,65.4,2,0
12/10/2017 19:25,43,68.3,60,63.6,103,65.6,2,0
12/10/2017 19:30,34,69,50,64.4,84,66.2,2,0
12/10/2017 19:35,34,68.9,50,64.2,84,66.1,2,0
12/10/2017 19:40,46,68.8,63,64.2,109,66.1,2,0
12/10/2017 19:45,30,69.1,46,64.5,76,66.3,2,0
12/10/2017 19:50,30,69.6,46,65,76,66.8,2,0
12/10/2017 19:55,31,69.8,47,65.2,78,67,2,0
12/10/2017 20:00,26,69,42,64.3,68,66.1,2,0
12/10/2017 20:05,37,69.2,53,64.6,90,66.5,2,0
12/10/2017 20:10,25,69.1,41,64.5,66,66.2,2,0
12/10/2017 20:15,28,69.5,44,64.9,72,66.6,2,0
12/10/2017 20:20,25,69.4,41,64.8,66,66.6,2,0
12/10/2017 20:25,25,69.2,42,64.5,67,66.2,2,0
12/10/2017 20:30,33,69.5,50,64.9,83,66.8,2,0
12/10/2017 20:35,35,68.9,52,64.2,87,66.1,2,0
12/10/2017 20:40,31,69.5,48,64.9,79,66.7,2,0
12/10/2017 20:45,27,69.3,44,64.7,71,66.5,2,0
12/10/2017 20:50,28,69.3,44,64.7,72,66.5,2,0
12/10/2017 20:55,28,68.8,45,64.1,73,65.9,2,0
12/10/2017 21:00,23,69,38,64.4,61,66.1,2,0
12/10/2017 21:05,19,69.2,35,64.5,54,66.2,2,0
12/10/2017 21:10,24,69.7,39,65.1,63,66.8,2,0
12/10/2017 21:15,33,68.7,49,64.1,82,66,2,0
12/10/2017 21:20,19,69.2,35,64.5,54,66.2,2,0
12/10/2017 21:25,24,69.3,39,64.7,63,66.4,2,0
12/10/2017 21:30,23,69.6,39,65,62,66.7,2,0
12/10/2017 21:35,24,69.5,40,64.9,64,66.6,2,0
12/10/2017 21:40,21,69.5,37,64.9,58,66.6,2,0
12/10/2017 21:45,28,69.4,45,64.8,73,66.6,2,0
12/10/2017 21:50,26,69.2,42,64.6,68,66.4,2,0
12/10/2017 21:55,25,69.1,41,64.5,66,66.2,2,0
12/10/2017 22:00,21,68.4,36,63.7,57,65.5,2,0
12/10/2017 22:05,24,68.8,40,64.2,64,65.9,2,0
12/10/2017 22:10,24,69,39,64.4,63,66.1,2,0
12/10/2017 22:15,19,69.3,35,64.7,54,66.3,2,0
12/10/2017 22:20,21,69.2,36,64.5,57,66.2,2,0
12/10/2017 22:25,20,69.2,35,64.6,55,66.3,2,0
12/10/2017 22:30,20,69.3,36,64.7,56,66.4,2,0
12/10/2017 22:35,7,69.3,22,64.7,29,65.8,2,0
12/10/2017 22:40,25,69.4,41,64.8,66,66.5,2,0
12/10/2017 22:45,18,69.4,33,64.8,51,66.4,2,0
12/10/2017 22:50,16,69.4,32,64.8,48,66.3,2,0
12/10/2017 22:55,19,69.6,34,65,53,66.6,2,0
12/10/2017 23:00,15,69.6,30,65,45,66.5,2,0
12/10/2017 23:05,11,69.5,27,64.9,38,66.2,2,0
12/10/2017 23:10,17,69.3,33,64.7,50,66.3,2,0
12/10/2017 23:15,15,69,30,64.4,45,65.9,2,0
12/10/2017 23:20,19,69.2,34,64.6,53,66.3,2,0
12/10/2017 23:25,16,68.9,32,64.3,48,65.8,2,0
12/10/2017 23:30,13,69,28,64.3,41,65.8,2,0
12/10/2017 23:35,19,69.2,34,64.6,53,66.2,2,0
12/10/2017 23:40,18,69.2,33,64.5,51,66.2,2,0
12/10/2017 23:45,14,69.3,29,64.7,43,66.2,2,0
12/10/2017 23:50,15,69.3,30,64.7,45,66.3,2,0
12/10/2017 23:55,12,69.3,27,64.7,39,66.1,2,0
