5 Minutes,Lane 1 Flow (Veh/5 Minutes),Lane 1 Speed (mph),Lane 2 Flow (Veh/5 Minutes),Lane 2 Speed (mph),Flow (Veh/5 Minutes),Speed (mph),# Lane Points,% Observed
10/16/2017 0:00,13,69.3,28,64.7,41,66.2,2,0
10/16/2017 0:05,13,69.3,28,64.7,41,66.2,2,0
10/16/2017 0:10,14,69.3,30,64.7,44,66.2,2,0
10/16/2017 0:15,12,69.2,27,64.6,39,66,2,0
10/16/2017 0:20,11,69.2,27,64.6,38,66,2,0
10/16/2017 0:25,10,69.2,25,64.5,35,65.9,2,0
10/16/2017 0:30,9,69.2,24,64.6,33,65.8,2,0
10/16/2017 0:35,8,69.1,24,64.5,32,65.7,2,0
10/16/2017 0:40,8,69.3,23,64.7,31,65.9,2,0
10/16/2017 0:45,11,69.3,26,64.7,37,66.1,2,0
10/16/2017 0:50,8,69.3,23,64.7,31,65.9,2,0
10/16/2017 0:55,8,69.3,23,64.7,31,65.9,2,0
10/16/2017 1:00,8,69.2,24,64.5,32,65.7,2,0
10/16/2017 1:05,6,69.1,21,64.5,27,65.5,2,0
10/16/2017 1:10,4,69.1,20,64.5,24,65.3,2,0
10/16/2017 1:15,7,69.3,22,64.7,29,65.8,2,0
10/16/2017 1:20,8,69.3,23,64.7,31,65.9,2,0
10/16/2017 1:25,7,69.4,22,64.8,29,66,2,0
10/16/2017 1:30,6,69.3,21,64.7,27,65.7,2,0
10/16/2017 1:35,5,69.4,20,64.8,25,65.7,2,0
10/16/2017 1:40,6,69.3,22,64.7,28,65.7,2,0
10/16/2017 1:45,5,69.2,21,64.6,26,65.5,2,0
10/16/2017 1:50,8,69.2,23,64.6,31,65.8,2,0
10/16/2017 1:55,10,69.2,20,64.6,30,66.2,2,0
10/16/2017 2:00,7,69,22,64.4,29,65.5,2,0
10/16/2017 2:05,4,69.1,20,64.5,24,65.2,2,0
10/16/2017 2:10,8,69.2,23,64.5,31,65.7,2,0
10/16/2017 2:15,8,69.3,23,64.7,31,65.9,2,0
10/16/2017 2:20,5,69.4,20,64.8,25,65.7,2,0
10/16/2017 2:25,5,69.1,21,64.5,26,65.4,2,0
10/16/2017 2:30,8,69.1,24,64.5,32,65.7,2,0
10/16/2017 2:35,10,69.3,26,64.7,36,65.9,2,0
10/16/2017 2:40,7,69.3,22,64.7,29,65.8,2,0
10/16/2017 2:45,8,69.4,23,64.8,31,66,2,0
10/16/2017 2:50,7,69.3,23,64.7,30,65.8,2,0
10/16/2017 2:55,7,69.3,22,64.7,29,65.8,2,0
10/16/2017 3:00,9,69.4,25,64.8,34,66,2,0
10/16/2017 3:05,9,69.4,25,64.8,34,66,2,0
10/16/2017 3:10,7,69.4,23,64.8,30,65.9,2,0
10/16/2017 3:15,8,69.3,24,64.7,32,65.8,2,0
10/16/2017 3:20,10,68.8,26,64.2,36,65.4,2,0
10/16/2017 3:25,9,69.1,25,64.5,34,65.8,2,0
10/16/2017 3:30,14,69.3,30,64.7,44,66.2,2,0
10/16/2017 3:35,11,69.4,26,64.8,37,66.2,2,0
10/16/2017 3:40,10,69.3,26,64.7,36,66,2,0
10/16/2017 3:45,13,69.4,28,64.8,41,66.2,2,0
10/16/2017 3:50,16,69.5,31,64.9,47,66.5,2,0
10/16/2017 3:55,13,69.5,29,65,42,66.4,2,0
10/16/2017 4:00,15,69.6,31,65,46,66.5,2,0
10/16/2017 4:05,16,69.5,32,65,48,66.5,2,0
10/16/2017 4:10,21,69.3,38,64.7,59,66.4,2,0
10/16/2017 4:15,22,68.9,38,64.3,60,66,2,0
10/16/2017 4:20,21,68.8,37,64.1,58,65.8,2,0
10/16/2017 4:25,28,68.8,45,64.2,73,65.9,2,0
10/16/2017 4:30,26,69.3,43,64.7,69,66.4,2,0
10/16/2017 4:35,34,69.9,51,65.4,85,67.2,2,0
10/16/2017 4:40,43,69.5,61,64.9,104,66.8,2,0
10/16/2017 4:45,33,69.3,51,64.7,84,66.5,2,0
10/16/2017 4:50,43,70.2,61,65.7,104,67.6,2,0
10/16/2017 4:55,43,70.8,61,66.4,104,68.2,2,0
10/16/2017 5:00,44,69.4,63,64.8,107,66.7,2,0
10/16/2017 5:05,41,69.1,60,64.4,101,66.3,2,0
10/16/2017 5:10,46,69.4,65,64.8,111,66.7,2,0
10/16/2017 5:15,48,68.1,68,63.4,116,65.4,2,0
10/16/2017 5:20,55,69.4,75,64.8,130,66.7,2,0
10/16/2017 5:25,65,68.9,87,64.3,152,66.3,2,0
10/16/2017 5:30,52,68.4,73,63.8,125,65.7,2,0
10/16/2017 5:35,65,68.3,88,63.6,153,65.6,2,0
10/16/2017 5:40,67,68.7,88,64.1,155,66.1,2,0
10/16/2017 5:45,70,69.4,91,64.8,161,66.8,2,0
10/16/2017 5:50,75,68.9,97,64.3,172,66.3,2,0
10/16/2017 5:55,68,68.5,91,63.8,159,65.8,2,0
10/16/2017 6:00,59,67.9,80,63.1,139,65.2,2,0
10/16/2017 6:05,60,66.5,81,61.7,141,63.7,2,0
10/16/2017 6:10,66,65.7,88,60.8,154,62.9,2,0
10/16/2017 6:15,69,66.5,91,61.5,160,63.7,2,0
10/16/2017 6:20,71,67.2,93,62.3,164,64.5,2,0
10/16/2017 6:25,74,67.2,96,62.3,170,64.5,2,0
10/16/2017 6:30,61,67.3,82,62.4,143,64.5,2,0
10/16/2017 6:35,71,66.2,93,61.2,164,63.4,2,0
10/16/2017 6:40,73,66.8,95,61.9,168,64,2,0
10/16/2017 6:45,81,65.8,104,60.8,185,63,2,0
10/16/2017 6:50,75,65.6,98,60.5,173,62.7,2,0
10/16/2017 6:55,64,66.3,85,61.4,149,63.5,2,0
10/16/2017 7:00,66,67.3,88,62.4,154,64.5,2,0
10/16/2017 7:05,72,67.3,94,62.5,166,64.6,2,0
10/16/2017 7:10,71,68.1,93,63.4,164,65.4,2,0
10/16/2017 7:15,81,68.3,104,63.5,185,65.6,2,0
10/16/2017 7:20,84,67.6,106,62.7,190,64.9,2,0
10/16/2017 7:25,90,67.9,113,63,203,65.2,2,0
10/16/2017 7:30,82,68.5,105,63.7,187,65.8,2,0
10/16/2017 7:35,87,67.8,110,63,197,65.1,2,0
10/16/2017 7:40,85,67.3,109,62.4,194,64.5,2,0
10/16/2017 7:45,88,68.1,111,63.2,199,65.3,2,0
10/16/2017 7:50,75,67.9,98,63.1,173,65.2,2,0
10/16/2017 7:55,79,69.1,103,64.4,182,66.4,2,0
10/16/2017 8:00,78,68.4,100,63.6,178,65.7,2,0
10/16/2017 8:05,87,67.5,111,62.6,198,64.7,2,0
10/16/2017 8:10,79,66.8,101,61.8,180,64,2,0
10/16/2017 8:15,78,65.7,101,60.6,179,62.8,2,0
10/16/2017 8:20,86,65.4,109,60.3,195,62.6,2,0
10/16/2017 8:25,80,65.9,102,60.8,182,63,2,0
10/16/2017 8:30,82,66.2,105,61.2,187,63.4,2,0
10/16/2017 8:35,87,65.6,110,60.5,197,62.8,2,0
10/16/2017 8:40,77,64.2,99,59,176,61.3,2,0
10/16/2017 8:45,75,64.7,97,59.6,172,61.8,2,0
10/16/2017 8:50,76,65.5,97,60.4,173,62.6,2,0
10/16/2017 8:55,76,65.3,97,60.3,173,62.5,2,0
10/16/2017 9:00,65,64.6,86,59.4,151,61.7,2,0
10/16/2017 9:05,67,64.9,87,59.8,154,62,2,0
10/16/2017 9:10,72,65.3,94,60.3,166,62.5,2,0
10/16/2017 9:15,63,65.1,84,60,147,62.2,2,0
10/16/2017 9:20,66,65.2,86,60.1,152,62.3,2,0
10/16/2017 9:25,66,66.1,86,61.2,152,63.3,2,0
10/16/2017 9:30,84,67.4,104,62.6,188,64.7,2,0
10/16/2017 9:35,69,66.8,89,61.9,158,64.1,2,0
10/16/2017 9:40,70,65.9,90,60.8,160,63,2,0
10/16/2017 9:45,70,65.6,90,60.6,160,62.8,2,0
10/16/2017 9:50,65,66,85,61,150,63.2,2,0
10/16/2017 9:55,66,65.3,86,60.2,152,62.4,2,0
10/16/2017 10:00,68,64.8,88,59.7,156,62,2,0
10/16/2017 10:05,68,66.7,89,61.9,157,64,2,0
10/16/2017 10:10,59,66.7,78,61.9,137,64,2,0
10/16/2017 10:15,51,65.8,69,61,120,63,2,0
10/16/2017 10:20,41,66.7,57,61.9,98,63.9,2,0
10/16/2017 10:25,57,65.4,75,60.6,132,62.7,2,0
10/16/2017 10:30,47,65.9,65,61.1,112,63.1,2,0
10/16/2017 10:35,44,67,62,62.3,106,64.2,2,0
10/16/2017 10:40,55,67.3,73,62.6,128,64.6,2,0
10/16/2017 10:45,58,66.3,76,61.5,134,63.6,2,0
10/16/2017 10:50,47,67.2,63,62.5,110,64.5,2,0
10/16/2017 10:55,56,68.1,74,63.5,130,65.5,2,0
10/16/2017 11:00,49,68.3,67,63.7,116,65.6,2,0
10/16/2017 11:05,64,68,83,63.3,147,65.3,2,0
10/16/2017 11:10,57,67.5,75,62.7,132,64.7,2,0
10/16/2017 11:15,61,67.6,81,62.8,142,64.9,2,0
10/16/2017 11:20,61,67.1,80,62.3,141,64.4,2,0
10/16/2017 11:25,58,68.6,76,63.9,134,65.9,2,0
10/16/2017 11:30,50,70.3,67,65.7,117,67.6,2,0
10/16/2017 11:35,66,68.7,85,64,151,66,2,0
10/16/2017 11:40,54,69.1,72,64.4,126,66.4,2,0
10/16/2017 11:45,56,68.3,74,63.6,130,65.6,2,0
10/16/2017 11:50,54,68.5,72,63.8,126,65.8,2,0
10/16/2017 11:55,60,67.7,79,63,139,65,2,0
10/16/2017 12:00,46,67.3,64,62.6,110,64.6,2,0
10/16/2017 12:05,51,68.4,69,63.7,120,65.7,2,0
10/16/2017 12:10,49,68.6,67,63.9,116,65.9,2,0
10/16/2017 12:15,49,67.7,66,63,115,65,2,0
10/16/2017 12:20,46,67.1,63,62.3,109,64.3,2,0
10/16/2017 12:25,43,67.2,60,62.4,103,64.4,2,0
10/16/2017 12:30,49,65.9,67,61,116,63,2,0
10/16/2017 12:35,49,67.6,67,62.9,116,64.9,2,0
10/16/2017 12:40,47,68.2,65,63.5,112,65.5,2,0
10/16/2017 12:45,51,67.5,69,62.8,120,64.8,2,0
10/16/2017 12:50,53,67.3,71,62.5,124,64.5,2,0
10/16/2017 12:55,50,68.8,68,64.2,118,66.1,2,0
10/16/2017 13:00,46,69,63,64.5,109,66.4,2,0
10/16/2017 13:05,51,68.9,68,64.3,119,66.3,2,0
10/16/2017 13:10,54,68.4,72,63.7,126,65.7,2,0
10/16/2017 13:15,49,69,67,64.4,116,66.3,2,0
10/16/2017 13:20,52,69,70,64.3,122,66.3,2,0
10/16/2017 13:25,45,69.3,62,64.6,107,66.6,2,0
10/16/2017 13:30,49,69.7,67,65.2,116,67.1,2,0
10/16/2017 13:35,48,69.4,66,64.8,114,66.7,2,0
10/16/2017 13:40,50,68.7,68,64.1,118,66.1,2,0
10/16/2017 13:45,44,69.2,61,64.6,105,66.5,2,0
10/16/2017 13:50,38,68.9,54,64.4,92,66.3,2,0
10/16/2017 13:55,43,68.6,60,64,103,65.9,2,0
10/16/2017 14:00,45,68.7,62,64.1,107,66,2,0
10/16/2017 14:05,58,68.1,77,63.5,135,65.5,2,0
10/16/2017 14:10,50,67.5,68,62.8,118,64.8,2,0
10/16/2017 14:15,45,66.8,62,62,107,64,2,0
10/16/2017 14:20,57,67.2,75,62.4,132,64.5,2,0
10/16/2017 14:25,44,68,62,63.4,106,65.3,2,0
10/16/2017 14:30,53,67.7,71,63,124,65,2,0
10/16/2017 14:35,48,68.7,65,64.1,113,66.1,2,0
10/16/2017 14:40,50,68.5,69,63.9,119,65.8,2,0
10/16/2017 14:45,50,69.1,68,64.5,118,66.4,2,0
10/16/2017 14:50,49,69.2,66,64.6,115,66.6,2,0
10/16/2017 14:55,39,69.5,56,65,95,66.8,2,0
10/16/2017 15:00,44,68.4,62,63.7,106,65.6,2,0
10/16/2017 15:05,46,68.3,63,63.6,109,65.6,2,0
10/16/2017 15:10,47,66.2,65,61.3,112,63.3,2,0
10/16/2017 15:15,53,66.8,72,62.1,125,64.1,2,0
10/16/2017 15:20,49,66.6,67,61.8,116,63.8,2,0
10/16/2017 15:25,52,68.1,70,63.5,122,65.5,2,0
10/16/2017 15:30,52,68.8,70,64.2,122,66.1,2,0
10/16/2017 15:35,44,67.2,62,62.5,106,64.4,2,0
10/16/2017 15:40,54,69.1,72,64.5,126,66.5,2,0
10/16/2017 15:45,61,69,80,64.4,141,66.4,2,0
10/16/2017 15:50,53,69.2,71,64.6,124,66.6,2,0
10/16/2017 15:55,60,68,79,63.3,139,65.4,2,0
10/16/2017 16:00,54,68.5,71,63.9,125,65.9,2,0
10/16/2017 16:05,48,69.5,65,65,113,66.9,2,0
10/16/2017 16:10,58,68.4,78,63.8,136,65.8,2,0
10/16/2017 16:15,63,67.6,82,62.8,145,64.9,2,0
10/16/2017 16:20,66,67.5,85,62.8,151,64.8,2,0
10/16/2017 16:25,57,69.2,76,64.6,133,66.6,2,0
10/16/2017 16:30,56,69.4,74,64.8,130,66.7,2,0
10/16/2017 16:35,60,69.5,78,64.9,138,66.9,2,0
10/16/2017 16:40,56,69.8,74,65.3,130,67.2,2,0
10/16/2017 16:45,61,69.4,81,64.8,142,66.8,2,0
10/16/2017 16:50,53,69.4,70,64.7,123,66.7,2,0
10/16/2017 16:55,50,69.4,68,64.8,118,66.7,2,0
10/16/2017 17:00,50,69.7,67,65,117,67,2,0
10/16/2017 17:05,48,70.3,66,65.8,114,67.7,2,0
10/16/2017 17:10,62,69.6,81,65,143,67,2,0
10/16/2017 17:15,60,68.8,79,64.1,139,66.1,2,0
10/16/2017 17:20,50,68.7,68,64,118,66,2,0
10/16/2017 17:25,50,69.8,68,65.2,118,67.1,2,0
10/16/2017 17:30,55,69.3,73,64.6,128,66.6,2,0
10/16/2017 17:35,53,69.9,70,65.3,123,67.3,2,0
10/16/2017 17:40,58,69.7,76,65.1,134,67.1,2,0
10/16/2017 17:45,47,70.4,65,65.9,112,67.8,2,0
10/16/2017 17:50,51,69.2,69,64.5,120,66.5,2,0
10/16/2017 17:55,45,68.7,63,64.1,108,66,2,0
10/16/2017 18:00,52,67.6,70,62.9,122,64.9,2,0
10/16/2017 18:05,45,68.6,62,64,107,65.9,2,0
10/16/2017 18:10,39,69.6,55,65,94,66.9,2,0
10/16/2017 18:15,46,69,63,64.5,109,66.4,2,0
10/16/2017 18:20,50,67.6,68,62.9,118,64.9,2,0
10/16/2017 18:25,44,68.2,61,63.5,105,65.4,2,0
10/16/2017 18:30,44,69.1,61,64.5,105,66.4,2,0
10/16/2017 18:35,42,68.4,60,63.8,102,65.7,2,0
10/16/2017 18:40,49,68,68,63.3,117,65.3,2,0
10/16/2017 18:45,39,68.3,57,63.6,96,65.5,2,0
10/16/2017 18:50,48,68.3,65,63.6,113,65.6,2,0
10/16/2017 18:55,41,69,59,64.4,100,66.3,2,0
10/16/2017 19:00,42,69.4,59,64.8,101,66.7,2,0
10/16/2017 19:05,41,67.6,59,62.8,100,64.8,2,0
10/16/2017 19:10,42,67.7,59,62.9,101,64.9,2,0
10/16/2017 19:15,45,68.8,62,64.2,107,66.1,2,0
10/16/2017 19:20,44,68.9,61,64.2,105,66.1,2,0
10/16/2017 19:25,41,67.8,57,63,98,65,2,0
10/16/2017 19:30,44,65.8,61,60.9,105,62.9,2,0
10/16/2017 19:35,39,67.2,56,62.4,95,64.3,2,0
10/16/2017 19:40,32,67.9,49,63.1,81,65,2,0
10/16/2017 19:45,31,68.3,48,63.6,79,65.4,2,0
10/16/2017 19:50,36,69.2,51,64.5,87,66.5,2,0
10/16/2017 19:55,30,69.5,47,64.9,77,66.6,2,0
10/16/2017 20:00,28,69.5,44,64.9,72,66.7,2,0
10/16/2017 20:05,26,68.7,42,64,68,65.8,2,0
10/16/2017 20:10,30,69.1,47,64.4,77,66.3,2,0
10/16/2017 20:15,32,69.3,48,64.7,80,66.5,2,0
10/16/2017 20:20,25,69.1,41,64.5,66,66.2,2,0
10/16/2017 20:25,33,68.9,50,64.3,83,66.1,2,0
10/16/2017 20:30,29,68.7,45,64.1,74,65.9,2,0
10/16/2017 20:35,30,69.1,46,64.5,76,66.3,2,0
10/16/2017 20:40,30,69.2,47,64.6,77,66.4,2,0
10/16/2017 20:45,27,69.4,43,64.8,70,66.6,2,0
10/16/2017 20:50,31,68.7,48,64.1,79,65.9,2,0
10/16/2017 20:55,31,68.7,47,64,78,65.9,2,0
10/16/2017 21:00,26,69.1,42,64.5,68,66.3,2,0
10/16/2017 21:05,26,69,42,64.4,68,66.2,2,0
10/16/2017 21:10,25,67.7,41,63,66,64.7,2,0
10/16/2017 21:15,23,67.9,39,63.2,62,65,2,0
10/16/2017 21:20,25,68.2,41,63.5,66,65.3,2,0
10/16/2017 21:25,27,69.3,43,64.7,70,66.5,2,0
10/16/2017 21:30,21,69.6,36,65,57,66.7,2,0
10/16/2017 21:35,25,69.5,41,64.9,66,66.6,2,0
10/16/2017 21:40,22,69.4,38,64.8,60,66.5,2,0
10/16/2017 21:45,20,69.5,35,64.9,55,66.5,2,0
10/16/2017 21:50,24,69.2,40,64.6,64,66.4,2,0
10/16/2017 21:55,21,68.6,36,64,57,65.7,2,0
10/16/2017 22:00,19,69.1,34,64.5,53,66.2,2,0
10/16/2017 22:05,22,69.4,38,64.7,60,66.4,2,0
10/16/2017 22:10,19,69.4,34,64.8,53,66.5,2,0
10/16/2017 22:15,20,69.5,36,64.9,56,66.5,2,0
10/16/2017 22:20,24,69.3,40,64.7,64,66.4,2,0
10/16/2017 22:25,21,69.2,37,64.6,58,66.3,2,0
10/16/2017 22:30,18,69.3,33,64.7,51,66.3,2,0
10/16/2017 22:35,12,69.4,27,64.8,39,66.2,2,0
10/16/2017 22:40,17,69.4,33,64.8,50,66.3,2,0
10/16/2017 22:45,12,69.4,28,64.8,40,66.2,2,0
10/16/2017 22:50,17,69.1,32,64.5,49,66.1,2,0
10/16/2017 22:55,11,69.3,26,64.7,37,66,2,0
10/16/2017 23:00,13,69.4,28,64.8,41,66.2,2,0
10/16/2017 23:05,14,69.5,29,64.9,43,66.4,2,0
10/16/2017 23:10,14,69.4,29,64.8,43,66.3,2,0
10/16/2017 23:15,13,69.4,29,64.7,42,66.2,2,0
10/16/2017 23:20,11,69.3,27,64.7,38,66.1,2,0
10/16/2017 23:25,11,69.2,26,64.6,37,66,2,0
10/16/2017 23:30,16,69,32,64.3,48,65.9,2,0
10/16/2017 23:35,13,69.1,28,64.5,41,65.9,2,0
10/16/2017 23:40,12,69.2,27,64.6,39,66,2,0
10/16/2017 23:45,18,69.4,33,64.8,51,66.4,2,0
10/16/2017 23:50,10,69.4,26,64.8,36,66,2,0
10/16/2017 23:55,9,69.4,24,64.8,33,66.1,2,0
10/17/2017 0:00,12,69.3,27,64.7,39,66.2,2,0
10/17/2017 0:05,10,69.4,25,64.8,35,66.1,2,0
10/17/2017 0:10,8,69.3,24,64.7,32,65.8,2,0
10/17/2017 0:15,13,69.2,28,64.6,41,66,2,0
10/17/2017 0:20,10,69.4,25,64.8,35,66.1,2,0
10/17/2017 0:25,7,69.4,22,64.8,29,65.9,2,0
10/17/2017 0:30,9,69.3,24,64.7,33,66,2,0
10/17/2017 0:35,9,69.3,24,64.7,33,66,2,0
10/17/2017 0:40,9,68.9,24,64.3,33,65.5,2,0
10/17/2017 0:45,8,69.2,23,64.5,31,65.7,2,0
10/17/2017 0:50,7,69.2,23,64.6,30,65.7,2,0
10/17/2017 0:55,7,69.2,22,64.6,29,65.7,2,0
10/17/2017 1:00,15,69.3,22,64.7,37,66.5,2,0
10/17/2017 1:05,7,69.3,22,64.7,29,65.8,2,0
10/17/2017 1:10,5,69.3,20,64.7,25,65.6,2,0
10/17/2017 1:15,8,69.3,23,64.7,31,65.9,2,0
10/17/2017 1:20,5,69.3,21,64.7,26,65.6,2,0
10/17/2017 1:25,6,69.3,21,64.7,27,65.7,2,0
10/17/2017 1:30,8,69.3,23,64.7,31,65.9,2,0
10/17/2017 1:35,13,69.3,28,64.7,41,66.2,2,0
10/17/2017 1:40,7,69.3,22,64.7,29,65.8,2,0
10/17/2017 1:45,10,69.3,20,64.7,30,66.3,2,0
10/17/2017 1:50,6,69.3,22,64.7,28,65.6,2,0
10/17/2017 1:55,8,69.2,23,64.6,31,65.8,2,0
10/17/2017 2:00,5,69.3,21,64.7,26,65.5,2,0
10/17/2017 2:05,5,69.3,20,64.7,25,65.6,2,0
10/17/2017 2:10,8,69,24,64.4,32,65.5,2,0
10/17/2017 2:15,8,69.3,23,64.7,31,65.8,2,0
10/17/2017 2:20,6,69.2,21,64.6,27,65.6,2,0
10/17/2017 2:25,9,69.3,24,64.7,33,66,2,0
10/17/2017 2:30,8,69,23,64.3,31,65.5,2,0
10/17/2017 2:35,8,69,23,64.3,31,65.5,2,0
10/17/2017 2:40,9,69.2,24,64.6,33,65.8,2,0
10/17/2017 2:45,9,69.2,24,64.6,33,65.8,2,0
10/17/2017 2:50,9,69,25,64.4,34,65.6,2,0
10/17/2017 2:55,8,69.3,24,64.6,32,65.8,2,0
10/17/2017 3:00,9,69.2,24,64.6,33,65.8,2,0
10/17/2017 3:05,11,69.3,27,64.6,38,66,2,0
10/17/2017 3:10,11,69.4,27,64.8,38,66.1,2,0
10/17/2017 3:15,11,69.4,27,64.8,38,66.1,2,0
10/17/2017 3:20,7,69.4,23,64.8,30,65.9,2,0
10/17/2017 3:25,11,69.4,27,64.8,38,66.1,2,0
10/17/2017 3:30,15,69.3,30,64.7,45,66.2,2,0
10/17/2017 3:35,11,69.3,27,64.7,38,66.1,2,0
10/17/2017 3:40,9,69.4,25,64.8,34,66,2,0
10/17/2017 3:45,14,69.5,29,64.9,43,66.4,2,0
10/17/2017 3:50,15,69.5,31,64.9,46,66.4,2,0
10/17/2017 3:55,11,69.3,26,64.7,37,66.1,2,0
10/17/2017 4:00,15,68.9,31,64.2,46,65.7,2,0
10/17/2017 4:05,19,69.1,35,64.5,54,66.2,2,0
10/17/2017 4:10,18,69.1,34,64.5,52,66.1,2,0
10/17/2017 4:15,21,69.2,37,64.6,58,66.3,2,0
10/17/2017 4:20,25,69.7,41,65.1,66,66.8,2,0
10/17/2017 4:25,28,68.5,45,63.9,73,65.7,2,0
10/17/2017 4:30,26,68.9,43,64.3,69,66,2,0
10/17/2017 4:35,29,69,47,64.3,76,66.1,2,0
10/17/2017 4:40,33,69.6,50,65,83,66.8,2,0
10/17/2017 4:45,36,68.8,53,64.1,89,66,2,0
10/17/2017 4:50,41,69.9,59,65.3,100,67.2,2,0
10/17/2017 4:55,38,70.4,56,65.9,94,67.7,2,0
10/17/2017 5:00,43,70.3,62,65.7,105,67.6,2,0
10/17/2017 5:05,50,70.1,69,65.5,119,67.4,2,0
10/17/2017 5:10,43,68.8,62,64.1,105,66,2,0
10/17/2017 5:15,51,68.4,71,63.7,122,65.7,2,0
10/17/2017 5:20,55,69.6,75,65,130,67,2,0
10/17/2017 5:25,56,69.9,77,65.3,133,67.3,2,0
10/17/2017 5:30,58,69.9,79,65.2,137,67.2,2,0
10/17/2017 5:35,64,68,85,63.3,149,65.3,2,0
10/17/2017 5:40,65,68.2,86,63.4,151,65.4,2,0
10/17/2017 5:45,73,67.7,96,62.9,169,65,2,0
10/17/2017 5:50,66,68.5,87,63.7,153,65.8,2,0
10/17/2017 5:55,65,67.1,87,62.3,152,64.3,2,0
10/17/2017 6:00,59,67.3,80,62.4,139,64.5,2,0
10/17/2017 6:05,68,67.4,89,62.5,157,64.7,2,0
10/17/2017 6:10,61,66.1,82,61.1,143,63.3,2,0
10/17/2017 6:15,55,66.1,76,61.1,131,63.2,2,0
10/17/2017 6:20,63,66.9,84,61.9,147,64,2,0
10/17/2017 6:25,55,68.2,76,63.4,131,65.4,2,0
10/17/2017 6:30,66,66.4,88,61.4,154,63.6,2,0
10/17/2017 6:35,66,66.4,88,61.3,154,63.5,2,0
10/17/2017 6:40,66,66.7,87,61.7,153,63.9,2,0
10/17/2017 6:45,67,67,88,62,155,64.2,2,0
10/17/2017 6:50,78,67.6,101,62.7,179,64.8,2,0
10/17/2017 6:55,70,68.3,92,63.4,162,65.5,2,0
10/17/2017 7:00,65,67.1,87,62.1,152,64.2,2,0
10/17/2017 7:05,65,67,86,62,151,64.1,2,0
10/17/2017 7:10,75,67,97,62.1,172,64.2,2,0
10/17/2017 7:15,73,67.4,95,62.5,168,64.6,2,0
10/17/2017 7:20,87,67.4,111,62.4,198,64.6,2,0
10/17/2017 7:25,87,66.2,111,61.2,198,63.4,2,0
10/17/2017 7:30,90,66.1,114,61.1,204,63.3,2,0
10/17/2017 7:35,87,67.1,110,62.2,197,64.4,2,0
10/17/2017 7:40,91,67.1,115,62.2,206,64.4,2,0
10/17/2017 7:45,89,67.6,112,62.7,201,64.9,2,0
10/17/2017 7:50,84,66.7,107,61.7,191,63.9,2,0
10/17/2017 7:55,83,64.8,106,59.6,189,61.9,2,0
10/17/2017 8:00,86,63.1,110,57.8,196,60.1,2,0
10/17/2017 8:05,86,64.1,109,58.8,195,61.2,2,0
10/17/2017 8:10,85,65.4,108,60.2,193,62.5,2,0
10/17/2017 8:15,85,65.3,107,60.2,192,62.5,2,0
10/17/2017 8:20,91,66,116,61,207,63.2,2,0
10/17/2017 8:25,69,66.2,91,61.2,160,63.4,2,0
10/17/2017 8:30,81,64.6,104,59.5,185,61.7,2,0
10/17/2017 8:35,83,65.8,105,60.7,188,62.9,2,0
10/17/2017 8:40,83,65.7,105,60.6,188,62.9,2,0
10/17/2017 8:45,81,65.3,102,60.2,183,62.4,2,0
10/17/2017 8:50,86,64.7,109,59.5,195,61.8,2,0
10/17/2017 8:55,87,64.8,110,59.6,197,61.9,2,0
10/17/2017 9:00,75,64.4,97,59.2,172,61.5,2,0
10/17/2017 9:05,82,65.2,104,60.1,186,62.4,2,0
10/17/2017 9:10,71,65.8,92,60.7,163,62.9,2,0
10/17/2017 9:15,79,67.2,100,62.3,179,64.4,2,0
10/17/2017 9:20,69,66.5,90,61.6,159,63.7,2,0
10/17/2017 9:25,68,66.6,89,61.8,157,63.9,2,0
10/17/2017 9:30,79,65.5,101,60.5,180,62.7,2,0
10/17/2017 9:35,62,65.9,82,60.9,144,63.1,2,0
10/17/2017 9:40,66,65.9,86,61,152,63.1,2,0
10/17/2017 9:45,72,65.3,93,60.3,165,62.5,2,0
10/17/2017 9:50,72,65.4,93,60.5,165,62.7,2,0
10/17/2017 9:55,67,65.7,87,60.8,154,62.9,2,0
10/17/2017 10:00,66,65.8,86,60.9,152,63,2,0
10/17/2017 10:05,67,66,87,61.2,154,63.3,2,0
10/17/2017 10:10,66,65.5,86,60.6,152,62.7,2,0
10/17/2017 10:15,69,65.8,88,60.8,157,63,2,0
10/17/2017 10:20,66,65.5,85,60.5,151,62.7,2,0
10/17/2017 10:25,63,66.5,83,61.6,146,63.7,2,0
10/17/2017 10:30,62,66.7,82,61.9,144,64,2,0
10/17/2017 10:35,58,66.2,77,61.4,135,63.5,2,0
10/17/2017 10:40,59,66.8,78,62,137,64.1,2,0
10/17/2017 10:45,60,66.7,80,61.9,140,63.9,2,0
10/17/2017 10:50,56,65.6,76,60.7,132,62.8,2,0
10/17/2017 10:55,63,66.3,82,61.4,145,63.5,2,0
10/17/2017 11:00,59,65.1,77,60.1,136,62.3,2,0
10/17/2017 11:05,63,65.1,77,60.2,140,62.4,2,0
10/17/2017 11:10,61,64.9,75,60,136,62.2,2,0
10/17/2017 11:15,67,63.3,82,58.2,149,60.5,2,0
10/17/2017 11:20,57,55.4,72,49.4,129,52.1,2,0
10/17/2017 11:25,66,60.3,80,54.8,146,57.3,2,0
10/17/2017 11:30,58,63.1,74,57.9,132,60.2,2,0
10/17/2017 11:35,55,65,73,59.9,128,62.1,2,0
10/17/2017 11:40,49,67.4,67,62.7,116,64.7,2,0
10/17/2017 11:45,65,67.8,85,63.1,150,65.2,2,0
10/17/2017 11:50,56,66.1,75,61.3,131,63.3,2,0
10/17/2017 11:55,52,66.6,70,61.7,122,63.8,2,0
10/17/2017 12:00,50,67.8,68,63,118,65,2,0
10/17/2017 12:05,54,68.3,72,63.6,126,65.6,2,0
10/17/2017 12:10,45,70,63,65.4,108,67.3,2,0
10/17/2017 12:15,54,68.5,72,63.7,126,65.7,2,0
10/17/2017 12:20,49,68.7,67,64.1,116,66,2,0
10/17/2017 12:25,48,69.3,66,64.6,114,66.6,2,0
10/17/2017 12:30,48,68.1,67,63.3,115,65.3,2,0
10/17/2017 12:35,55,68.5,72,63.8,127,65.9,2,0
10/17/2017 12:40,53,68,72,63.2,125,65.3,2,0
10/17/2017 12:45,50,69.7,68,65.1,118,67,2,0
10/17/2017 12:50,51,70.3,69,65.7,120,67.7,2,0
10/17/2017 12:55,42,68.7,59,64,101,65.9,2,0
10/17/2017 13:00,41,67.8,58,63,99,65,2,0
10/17/2017 13:05,54,68.2,72,63.4,126,65.5,2,0
10/17/2017 13:10,40,69.1,57,64.5,97,66.4,2,0
10/17/2017 13:15,48,69.4,65,64.8,113,66.8,2,0
10/17/2017 13:20,55,69.6,73,65,128,66.9,2,0
10/17/2017 13:25,51,68.2,69,63.5,120,65.5,2,0
10/17/2017 13:30,46,69,64,64.3,110,66.3,2,0
10/17/2017 13:35,60,68.8,79,64.1,139,66.1,2,0
10/17/2017 13:40,49,68.8,67,64.2,116,66.1,2,0
10/17/2017 13:45,54,67.8,73,63,127,65,2,0
10/17/2017 13:50,50,67.5,68,62.8,118,64.8,2,0
10/17/2017 13:55,50,67.8,68,63,118,65,2,0
10/17/2017 14:00,44,65.5,62,60.6,106,62.6,2,0
10/17/2017 14:05,40,66.9,57,62.2,97,64.1,2,0
10/17/2017 14:10,52,67.6,70,62.9,122,64.9,2,0
10/17/2017 14:15,44,68.4,62,63.6,106,65.6,2,0
10/17/2017 14:20,49,68.6,66,63.8,115,65.9,2,0
10/17/2017 14:25,44,66.8,62,62,106,64,2,0
10/17/2017 14:30,51,66.5,70,61.7,121,63.7,2,0
10/17/2017 14:35,58,67.3,77,62.6,135,64.6,2,0
10/17/2017 14:40,48,67.6,66,62.9,114,64.9,2,0
10/17/2017 14:45,58,67.2,78,62.4,136,64.5,2,0
10/17/2017 14:50,53,67.2,71,62.5,124,64.5,2,0
10/17/2017 14:55,55,69.5,73,64.9,128,66.9,2,0
10/17/2017 15:00,50,68.6,67,64,117,66,2,0
10/17/2017 15:05,53,69.2,71,64.6,124,66.6,2,0
10/17/2017 15:10,46,68.6,64,63.9,110,65.9,2,0
10/17/2017 15:15,52,67.6,71,62.7,123,64.8,2,0
10/17/2017 15:20,59,67.8,76,63.1,135,65.2,2,0
10/17/2017 15:25,59,68.7,77,64,136,66,2,0
10/17/2017 15:30,61,68,80,63.3,141,65.3,2,0
10/17/2017 15:35,69,68.2,88,63.4,157,65.5,2,0
10/17/2017 15:40,63,67.9,82,63.1,145,65.2,2,0
10/17/2017 15:45,69,68.3,88,63.6,157,65.7,2,0
10/17/2017 15:50,70,67.8,89,63.1,159,65.2,2,0
10/17/2017 15:55,57,68,76,63.3,133,65.3,2,0
10/17/2017 16:00,61,69.2,80,64.7,141,66.6,2,0
10/17/2017 16:05,61,69.4,78,64.8,139,66.8,2,0
10/17/2017 16:10,65,69.1,83,64.5,148,66.5,2,0
10/17/2017 16:15,64,69.4,84,64.7,148,66.7,2,0
10/17/2017 16:20,59,69.8,78,65.3,137,67.2,2,0
10/17/2017 16:25,67,70,85,65.5,152,67.5,2,0
10/17/2017 16:30,65,68.6,84,64,149,66,2,0
10/17/2017 16:35,53,67.4,72,62.6,125,64.6,2,0
10/17/2017 16:40,59,58.2,78,52.5,137,54.9,2,0
10/17/2017 16:45,49,60.2,67,54.5,116,56.9,2,0
10/17/2017 16:50,56,63.2,76,57.9,132,60.1,2,0
10/17/2017 16:55,46,65.9,64,60.9,110,63,2,0
10/17/2017 17:00,63,65.9,81,60.9,144,63.1,2,0
10/17/2017 17:05,53,66.3,71,61.4,124,63.5,2,0
10/17/2017 17:10,58,63.5,77,58.2,135,60.4,2,0
10/17/2017 17:15,63,57.7,83,51.7,146,54.3,2,0
10/17/2017 17:20,55,47.4,74,40.4,129,43.4,2,0
10/17/2017 17:25,55,38.6,74,30.7,129,34.1,2,0
10/17/2017 17:30,51,33.5,70,25,121,28.6,2,0
10/17/2017 17:35,54,31.2,73,22.5,127,26.2,2,0
10/17/2017 17:40,59,30.8,78,22,137,25.8,2,0
10/17/2017 17:45,47,30.6,65,21.7,112,25.5,2,0
10/17/2017 17:50,52,29.5,71,20.6,123,24.4,2,0
10/17/2017 17:55,52,30.8,70,22,122,25.7,2,0
10/17/2017 18:00,45,34.4,63,25.9,108,29.4,2,0
10/17/2017 18:05,45,39.8,62,31.8,107,35.1,2,0
10/17/2017 18:10,46,48.9,64,41.9,110,44.8,2,0
10/17/2017 18:15,54,58.6,72,52.8,126,55.3,2,0
10/17/2017 18:20,43,62.8,61,57.5,104,59.7,2,0
10/17/2017 18:25,40,65.7,58,60.5,98,62.6,2,0
10/17/2017 18:30,49,67.5,67,62.7,116,64.7,2,0
10/17/2017 18:35,42,68.6,59,63.9,101,65.9,2,0
10/17/2017 18:40,39,68.7,56,64,95,65.9,2,0
10/17/2017 18:45,38,67.6,55,62.8,93,64.8,2,0
10/17/2017 18:50,38,67.8,55,63,93,64.9,2,0
10/17/2017 18:55,38,68.5,55,63.7,93,65.7,2,0
10/17/2017 19:00,29,67.4,46,62.7,75,64.5,2,0
10/17/2017 19:05,33,68.1,50,63.4,83,65.3,2,0
10/17/2017 19:10,36,67.6,52,62.9,88,64.8,2,0
10/17/2017 19:15,33,67.1,49,62.3,82,64.3,2,0
10/17/2017 19:20,41,67.7,58,62.9,99,64.9,2,0
10/17/2017 19:25,37,68.3,54,63.4,91,65.4,2,0
10/17/2017 19:30,44,67.8,61,63,105,65,2,0
10/17/2017 19:35,30,68.3,46,63.5,76,65.4,2,0
10/17/2017 19:40,33,68.3,50,63.6,83,65.5,2,0
10/17/2017 19:45,34,69.2,50,64.6,84,66.5,2,0
10/17/2017 19:50,33,69.1,50,64.4,83,66.3,2,0
10/17/2017 19:55,37,69.4,54,64.8,91,66.7,2,0
10/17/2017 20:00,34,68.7,50,64,84,65.9,2,0
10/17/2017 20:05,30,68.6,46,63.9,76,65.8,2,0
10/17/2017 20:10,35,69.2,52,64.5,87,66.3,2,0
10/17/2017 20:15,31,69.2,47,64.6,78,66.4,2,0
10/17/2017 20:20,35,69.5,52,64.9,87,66.8,2,0
10/17/2017 20:25,39,69.3,56,64.7,95,66.6,2,0
10/17/2017 20:30,27,69.6,43,65,70,66.8,2,0
10/17/2017 20:35,30,69,46,64.4,76,66.2,2,0
10/17/2017 20:40,33,69,49,64.4,82,66.2,2,0
10/17/2017 20:45,28,69.3,44,64.7,72,66.5,2,0
10/17/2017 20:50,31,69.5,47,64.9,78,66.8,2,0
10/17/2017 20:55,29,69.5,46,64.9,75,66.7,2,0
10/17/2017 21:00,28,68.1,44,63.4,72,65.2,2,0
10/17/2017 21:05,27,68.6,43,63.8,70,65.7,2,0
10/17/2017 21:10,30,69.1,47,64.5,77,66.3,2,0
10/17/2017 21:15,27,69.5,43,64.9,70,66.6,2,0
10/17/2017 21:20,37,69.7,53,65.1,90,67,2,0
10/17/2017 21:25,40,69.2,57,64.5,97,66.5,2,0
10/17/2017 21:30,29,68.7,45,64.1,74,65.9,2,0
10/17/2017 21:35,37,67.7,53,63,90,64.9,2,0
10/17/2017 21:40,31,68.8,47,64.2,78,66,2,0
10/17/2017 21:45,33,69.4,49,64.8,82,66.6,2,0
10/17/2017 21:50,24,69.2,40,64.6,64,66.3,2,0
10/17/2017 21:55,28,69,44,64.4,72,66.2,2,0
10/17/2017 22:00,27,68.3,43,63.6,70,65.4,2,0
10/17/2017 22:05,23,68.7,39,64,62,65.7,2,0
10/17/2017 22:10,24,69.2,39,64.6,63,66.3,2,0
10/17/2017 22:15,20,69.2,36,64.6,56,66.3,2,0
10/17/2017 22:20,23,69.4,39,64.7,62,66.5,2,0
10/17/2017 22:25,19,69.5,34,64.9,53,66.5,2,0
10/17/2017 22:30,20,68.9,36,64.2,56,65.9,2,0
10/17/2017 22:35,17,69,33,64.4,50,65.9,2,0
10/17/2017 22:40,20,69.4,36,64.8,56,66.4,2,0
10/17/2017 22:45,19,69.3,36,64.7,55,66.3,2,0
10/17/2017 22:50,21,69.5,36,64.9,57,66.6,2,0
10/17/2017 22:55,17,69.5,33,64.9,50,66.5,2,0
10/17/2017 23:00,17,69.4,33,64.8,50,66.3,2,0
10/17/2017 23:05,20,69.4,35,64.8,55,66.5,2,0
10/17/2017 23:10,18,69.6,34,65,52,66.6,2,0
10/17/2017 23:15,17,69.6,33,65,50,66.6,2,0
10/17/2017 23:20,14,69.4,29,64.8,43,66.3,2,0
10/17/2017 23:25,13,69.4,28,64.8,41,66.3,2,0
10/17/2017 23:30,18,69.2,33,64.5,51,66.2,2,0
10/17/2017 23:35,17,69.1,33,64.5,50,66.1,2,0
10/17/2017 23:40,16,69.2,31,64.6,47,66.2,2,0
10/17/2017 23:45,15,69.2,31,64.6,46,66.1,2,0
10/17/2017 23:50,13,68.9,29,64.2,42,65.7,2,0
10/17/2017 23:55,12,68.9,28,64.3,40,65.7,2,0
10/18/2017 0:00,13,69.3,28,64.7,41,66.2,2,0
10/18/2017 0:05,12,69.3,28,64.7,40,66.1,2,0
10/18/2017 0:10,10,69,25,64.4,35,65.7,2,0
10/18/2017 0:15,9,69.2,24,64.5,33,65.8,2,0
10/18/2017 0:20,13,69.3,28,64.7,41,66.2,2,0
10/18/2017 0:25,9,69.4,24,64.8,33,66.1,2,0
10/18/2017 0:30,8,69.4,24,64.8,32,66,2,0
10/18/2017 0:35,9,69.2,24,64.6,33,65.9,2,0
10/18/2017 0:40,8,69.2,23,64.6,31,65.8,2,0
10/18/2017 0:45,7,69.1,23,64.5,30,65.6,2,0
10/18/2017 0:50,8,69.3,23,64.7,31,65.9,2,0
10/18/2017 0:55,9,69.2,24,64.6,33,65.9,2,0
10/18/2017 1:00,8,69.4,23,64.8,31,66,2,0
10/18/2017 1:05,7,69.4,22,64.8,29,65.9,2,0
10/18/2017 1:10,6,69.5,21,64.9,27,65.9,2,0
10/18/2017 1:15,6,69.4,21,64.8,27,65.8,2,0
10/18/2017 1:20,5,69.4,21,64.8,26,65.7,2,0
10/18/2017 1:25,6,69.4,21,64.8,27,65.8,2,0
10/18/2017 1:30,9,69.4,24,64.8,33,66,2,0
10/18/2017 1:35,10,69.4,26,64.8,36,66.1,2,0
10/18/2017 1:40,7,69.4,22,64.8,29,65.9,2,0
10/18/2017 1:45,10,69.5,20,64.9,30,66.4,2,0
10/18/2017 1:50,8,69.3,23,64.7,31,65.9,2,0
10/18/2017 1:55,7,69.2,22,64.6,29,65.7,2,0
10/18/2017 2:00,5,69.3,20,64.7,25,65.7,2,0
10/18/2017 2:05,8,69.4,23,64.8,31,66,2,0
10/18/2017 2:10,10,69.4,25,64.8,35,66.1,2,0
10/18/2017 2:15,7,69.4,22,64.8,29,65.9,2,0
10/18/2017 2:20,8,69.3,24,64.7,32,65.9,2,0
10/18/2017 2:25,7,69.4,22,64.8,29,65.9,2,0
10/18/2017 2:30,8,69.3,24,64.7,32,65.8,2,0
10/18/2017 2:35,8,69.1,23,64.4,31,65.6,2,0
10/18/2017 2:40,9,69.1,24,64.5,33,65.8,2,0
10/18/2017 2:45,9,69.2,25,64.5,34,65.8,2,0
10/18/2017 2:50,8,69.2,24,64.6,32,65.8,2,0
10/18/2017 2:55,9,69.4,24,64.8,33,66,2,0
10/18/2017 3:00,8,69.1,24,64.4,32,65.6,2,0
10/18/2017 3:05,12,69.1,28,64.5,40,65.9,2,0
10/18/2017 3:10,10,69.3,26,64.7,36,66,2,0
10/18/2017 3:15,10,69.1,25,64.5,35,65.8,2,0
10/18/2017 3:20,8,69,24,64.4,32,65.5,2,0
10/18/2017 3:25,11,69.2,27,64.6,38,65.9,2,0
10/18/2017 3:30,11,69.3,26,64.7,37,66,2,0
10/18/2017 3:35,9,69.4,25,64.8,34,66,2,0
10/18/2017 3:40,11,69.2,27,64.5,38,65.9,2,0
10/18/2017 3:45,15,69.2,31,64.6,46,66.1,2,0
10/18/2017 3:50,15,69.1,31,64.4,46,65.9,2,0
10/18/2017 3:55,12,69.2,28,64.6,40,66,2,0
10/18/2017 4:00,18,69.4,33,64.8,51,66.4,2,0
10/18/2017 4:05,18,69.3,34,64.7,52,66.3,2,0
10/18/2017 4:10,18,69.1,34,64.5,52,66.1,2,0
10/18/2017 4:15,15,68.9,30,64.3,45,65.9,2,0
10/18/2017 4:20,20,69,37,64.4,57,66,2,0
10/18/2017 4:25,27,69.3,44,64.7,71,66.5,2,0
10/18/2017 4:30,27,68.9,44,64.2,71,66,2,0
10/18/2017 4:35,31,69.2,49,64.6,80,66.4,2,0
10/18/2017 4:40,30,69,47,64.4,77,66.2,2,0
10/18/2017 4:45,47,68.5,66,63.9,113,65.8,2,0
10/18/2017 4:50,36,69,53,64.3,89,66.2,2,0
10/18/2017 4:55,41,68.8,59,64.1,100,66,2,0
10/18/2017 5:00,35,69,53,64.3,88,66.1,2,0
10/18/2017 5:05,42,68.7,59,64,101,65.9,2,0
10/18/2017 5:10,46,68.8,65,64.1,111,66.1,2,0
10/18/2017 5:15,53,70.1,73,65.6,126,67.5,2,0
10/18/2017 5:20,51,68.4,72,63.6,123,65.6,2,0
10/18/2017 5:25,60,68.8,81,64.1,141,66.1,2,0
10/18/2017 5:30,59,68.1,79,63.3,138,65.3,2,0
10/18/2017 5:35,65,69.2,88,64.5,153,66.5,2,0
10/18/2017 5:40,65,68.1,86,63.4,151,65.4,2,0
10/18/2017 5:45,70,66.9,92,62,162,64.1,2,0
10/18/2017 5:50,71,67.9,92,63.1,163,65.2,2,0
10/18/2017 5:55,60,68.2,81,63.4,141,65.4,2,0
10/18/2017 6:00,63,68.1,84,63.4,147,65.4,2,0
10/18/2017 6:05,65,67.4,87,62.5,152,64.6,2,0
10/18/2017 6:10,67,66.3,90,61.3,157,63.4,2,0
10/18/2017 6:15,66,66.1,88,61.1,154,63.2,2,0
10/18/2017 6:20,49,65.1,68,60,117,62.1,2,0
10/18/2017 6:25,74,66.1,96,61.1,170,63.3,2,0
10/18/2017 6:30,66,66.9,87,61.9,153,64.1,2,0
10/18/2017 6:35,63,66.6,83,61.5,146,63.7,2,0
10/18/2017 6:40,66,65.7,87,60.6,153,62.8,2,0
10/18/2017 6:45,69,62.7,91,57.3,160,59.6,2,0
10/18/2017 6:50,66,62,87,56.5,153,58.9,2,0
10/18/2017 6:55,59,63.3,80,57.9,139,60.2,2,0
10/18/2017 7:00,68,63.9,91,58.7,159,60.9,2,0
10/18/2017 7:05,66,65.2,88,60.1,154,62.3,2,0
10/18/2017 7:10,70,65.6,91,60.6,161,62.8,2,0
10/18/2017 7:15,84,66.7,107,61.7,191,63.9,2,0
10/18/2017 7:20,77,66.5,100,61.5,177,63.7,2,0
10/18/2017 7:25,81,66.9,104,61.9,185,64.1,2,0
10/18/2017 7:30,76,67.2,99,62.2,175,64.4,2,0
10/18/2017 7:35,81,67.5,104,62.6,185,64.7,2,0
10/18/2017 7:40,102,67.7,128,62.8,230,65,2,0
10/18/2017 7:45,89,66.7,113,61.8,202,64,2,0
10/18/2017 7:50,90,66.7,113,61.7,203,63.9,2,0
10/18/2017 7:55,87,67.9,110,63,197,65.2,2,0
10/18/2017 8:00,80,67,103,62,183,64.2,2,0
10/18/2017 8:05,92,65.6,117,60.6,209,62.8,2,0
10/18/2017 8:10,89,66.2,112,61.2,201,63.4,2,0
10/18/2017 8:15,75,66.1,95,61.1,170,63.3,2,0
10/18/2017 8:20,75,66.7,97,61.8,172,64,2,0
10/18/2017 8:25,86,66.7,109,61.7,195,63.9,2,0
10/18/2017 8:30,78,66.5,100,61.5,178,63.7,2,0
10/18/2017 8:35,77,66.4,99,61.5,176,63.6,2,0
10/18/2017 8:40,77,66.5,99,61.5,176,63.7,2,0
10/18/2017 8:45,84,65.4,107,60.4,191,62.6,2,0
10/18/2017 8:50,79,66.4,100,61.5,179,63.6,2,0
10/18/2017 8:55,83,66.2,106,61.2,189,63.4,2,0
10/18/2017 9:00,73,64.8,95,59.7,168,61.9,2,0
10/18/2017 9:05,85,64.5,107,59.3,192,61.6,2,0
10/18/2017 9:10,68,65.1,89,60.1,157,62.3,2,0
10/18/2017 9:15,70,64.3,92,59.2,162,61.4,2,0
10/18/2017 9:20,73,65.5,93,60.5,166,62.7,2,0
10/18/2017 9:25,72,63,92,57.8,164,60.1,2,0
10/18/2017 9:30,68,64.9,89,59.8,157,62,2,0
10/18/2017 9:35,76,65.6,96,60.7,172,62.9,2,0
10/18/2017 9:40,70,66.2,91,61.4,161,63.5,2,0
10/18/2017 9:45,75,67,96,62.2,171,64.3,2,0
10/18/2017 9:50,74,66,94,61,168,63.2,2,0
10/18/2017 9:55,66,66,86,61.1,152,63.2,2,0
10/18/2017 10:00,71,65,91,60,162,62.2,2,0
10/18/2017 10:05,70,66.5,91,61.6,161,63.7,2,0
10/18/2017 10:10,64,66.3,85,61.3,149,63.4,2,0
10/18/2017 10:15,64,66.3,83,61.4,147,63.6,2,0
10/18/2017 10:20,64,64.9,83,59.9,147,62.1,2,0
10/18/2017 10:25,62,65.1,82,60.1,144,62.2,2,0
10/18/2017 10:30,59,66,78,61.1,137,63.3,2,0
10/18/2017 10:35,58,65.5,77,60.6,135,62.7,2,0
10/18/2017 10:40,57,67.3,75,62.6,132,64.6,2,0
10/18/2017 10:45,68,66.7,87,61.9,155,64,2,0
10/18/2017 10:50,59,65.5,79,60.6,138,62.7,2,0
10/18/2017 10:55,59,66.7,78,61.8,137,63.9,2,0
10/18/2017 11:00,53,65.7,70,60.7,123,62.9,2,0
10/18/2017 11:05,56,66.1,73,61.2,129,63.3,2,0
10/18/2017 11:10,61,65.8,80,60.9,141,63,2,0
10/18/2017 11:15,65,66.2,84,61.4,149,63.5,2,0
10/18/2017 11:20,56,67.4,74,62.7,130,64.7,2,0
10/18/2017 11:25,61,68.3,79,63.7,140,65.7,2,0
10/18/2017 11:30,50,68.7,68,64.1,118,66,2,0
10/18/2017 11:35,50,66.6,68,61.8,118,63.8,2,0
10/18/2017 11:40,62,65.8,81,60.9,143,63,2,0
10/18/2017 11:45,54,65.6,72,60.8,126,62.9,2,0
10/18/2017 11:50,57,67.7,75,63,132,65,2,0
10/18/2017 11:55,51,67.7,68,63.1,119,65.1,2,0
10/18/2017 12:00,45,67.1,63,62.4,108,64.3,2,0
10/18/2017 12:05,59,66.1,78,61.4,137,63.4,2,0
10/18/2017 12:10,52,67.5,70,62.8,122,64.8,2,0
10/18/2017 12:15,54,68.9,72,64.2,126,66.2,2,0
10/18/2017 12:20,52,68.6,70,63.9,122,65.9,2,0
10/18/2017 12:25,51,67.9,69,63.1,120,65.1,2,0
10/18/2017 12:30,48,65.5,66,60.6,114,62.7,2,0
10/18/2017 12:35,58,66,77,61.1,135,63.2,2,0
10/18/2017 12:40,66,68.6,59,62.8,125,65.9,2,0
10/18/2017 12:45,65,68.6,58,62.8,123,65.9,2,0
10/18/2017 12:50,65,68.6,59,62.8,124,65.8,2,0
10/18/2017 12:55,64,68.5,58,62.7,122,65.7,2,0
10/18/2017 13:00,63,68.4,56,62.6,119,65.7,2,0
10/18/2017 13:05,64,68.4,57,62.6,121,65.7,2,0
10/18/2017 13:10,55,71.5,72,67,127,69,2,0
10/18/2017 13:15,43,69.7,60,65.1,103,67,2,0
10/18/2017 13:20,49,69.5,67,65,116,66.9,2,0
10/18/2017 13:25,50,69.2,69,64.6,119,66.5,2,0
10/18/2017 13:30,48,68.6,65,63.9,113,65.9,2,0
10/18/2017 13:35,57,68.4,77,63.7,134,65.7,2,0
10/18/2017 13:40,57,68.9,75,64.2,132,66.3,2,0
10/18/2017 13:45,51,68.5,69,63.8,120,65.8,2,0
10/18/2017 13:50,53,69.5,71,64.9,124,66.9,2,0
10/18/2017 13:55,53,69,72,64.2,125,66.2,2,0
10/18/2017 14:00,52,68.3,71,63.5,123,65.6,2,0
10/18/2017 14:05,58,68,77,63.1,135,65.2,2,0
10/18/2017 14:10,44,66.4,61,61.5,105,63.6,2,0
10/18/2017 14:15,63,66.4,82,61.4,145,63.6,2,0
10/18/2017 14:20,47,68.2,64,63.4,111,65.5,2,0
10/18/2017 14:25,47,66.4,65,61.5,112,63.5,2,0
10/18/2017 14:30,54,67.1,72,62.3,126,64.4,2,0
10/18/2017 14:35,48,68.6,66,63.9,114,65.9,2,0
10/18/2017 14:40,54,67.7,73,62.9,127,64.9,2,0
10/18/2017 14:45,62,66.9,81,62.2,143,64.2,2,0
10/18/2017 14:50,50,66.6,68,61.7,118,63.8,2,0
10/18/2017 14:55,44,67,61,62.3,105,64.2,2,0
10/18/2017 15:00,44,68.6,61,63.9,105,65.9,2,0
10/18/2017 15:05,44,69.2,61,64.6,105,66.5,2,0
10/18/2017 15:10,50,69.2,67,64.5,117,66.5,2,0
10/18/2017 15:15,58,68.6,76,64,134,66,2,0
10/18/2017 15:20,49,68.1,67,63.4,116,65.3,2,0
10/18/2017 15:25,58,68.5,77,63.8,135,65.9,2,0
10/18/2017 15:30,54,68.2,73,63.5,127,65.5,2,0
10/18/2017 15:35,51,68.3,70,63.6,121,65.6,2,0
10/18/2017 15:40,73,68.2,93,63.5,166,65.6,2,0
10/18/2017 15:45,64,69.2,83,64.6,147,66.6,2,0
10/18/2017 15:50,65,69,83,64.3,148,66.4,2,0
10/18/2017 15:55,62,67.4,81,62.5,143,64.6,2,0
10/18/2017 16:00,53,67.2,70,62.3,123,64.4,2,0
10/18/2017 16:05,55,67.5,72,62.7,127,64.8,2,0
10/18/2017 16:10,53,68.3,70,63.5,123,65.6,2,0
10/18/2017 16:15,62,69,80,64.3,142,66.4,2,0
10/18/2017 16:20,59,69.3,77,64.7,136,66.7,2,0
10/18/2017 16:25,60,68.3,77,63.6,137,65.6,2,0
10/18/2017 16:30,57,69.4,76,64.7,133,66.7,2,0
10/18/2017 16:35,63,69.4,81,64.8,144,66.8,2,0
10/18/2017 16:40,60,69.7,79,65.1,139,67.1,2,0
10/18/2017 16:45,60,69.1,79,64.4,139,66.4,2,0
10/18/2017 16:50,61,67.3,79,62.4,140,64.6,2,0
10/18/2017 16:55,59,67.5,77,62.7,136,64.8,2,0
10/18/2017 17:00,54,68,71,63.2,125,65.3,2,0
10/18/2017 17:05,39,67.8,57,63,96,64.9,2,0
10/18/2017 17:10,52,68.5,70,63.8,122,65.8,2,0
10/18/2017 17:15,50,68.2,68,63.4,118,65.4,2,0
10/18/2017 17:20,54,68.4,72,63.6,126,65.7,2,0
10/18/2017 17:25,49,68.2,68,63.4,117,65.4,2,0
10/18/2017 17:30,52,68.8,70,64.1,122,66.1,2,0
10/18/2017 17:35,47,62.4,66,57,113,59.2,2,0
10/18/2017 17:40,42,58.8,60,52.9,102,55.3,2,0
10/18/2017 17:45,40,63.1,57,57.6,97,59.9,2,0
10/18/2017 17:50,45,66.1,62,61.1,107,63.2,2,0
10/18/2017 17:55,48,68.1,66,63.2,114,65.3,2,0
10/18/2017 18:00,42,67.3,60,62.5,102,64.5,2,0
10/18/2017 18:05,54,67.5,73,62.8,127,64.8,2,0
10/18/2017 18:10,53,69.1,71,64.5,124,66.5,2,0
10/18/2017 18:15,50,69.1,67,64.5,117,66.4,2,0
10/18/2017 18:20,57,68.4,75,63.7,132,65.7,2,0
10/18/2017 18:25,53,69.3,72,64.7,125,66.6,2,0
10/18/2017 18:30,45,68.6,62,63.8,107,65.8,2,0
10/18/2017 18:35,53,68.1,71,63.4,124,65.4,2,0
10/18/2017 18:40,48,69.3,66,64.6,114,66.6,2,0
10/18/2017 18:45,48,69.3,66,64.6,114,66.6,2,0
10/18/2017 18:50,46,69.2,64,64.6,110,66.5,2,0
10/18/2017 18:55,48,68.9,65,64.2,113,66.2,2,0
10/18/2017 19:00,33,68.7,50,64,83,65.9,2,0
10/18/2017 19:05,42,68.5,59,63.8,101,65.7,2,0
10/18/2017 19:10,46,67.7,63,62.8,109,64.9,2,0
10/18/2017 19:15,45,67.7,64,62.9,109,64.8,2,0
10/18/2017 19:20,48,67,66,62.1,114,64.1,2,0
10/18/2017 19:25,52,66.4,70,61.4,122,63.5,2,0
10/18/2017 19:30,35,67.4,52,62.5,87,64.5,2,0
10/18/2017 19:35,36,67.3,52,62.5,88,64.5,2,0
10/18/2017 19:40,34,68.6,51,63.9,85,65.8,2,0
10/18/2017 19:45,41,68.5,58,63.8,99,65.8,2,0
10/18/2017 19:50,42,68,60,63.2,102,65.1,2,0
10/18/2017 19:55,37,68.6,54,63.8,91,65.8,2,0
10/18/2017 20:00,34,68.7,51,64.1,85,65.9,2,0
10/18/2017 20:05,35,69,51,64.3,86,66.2,2,0
10/18/2017 20:10,37,68.9,54,64.2,91,66.1,2,0
10/18/2017 20:15,40,68.9,56,64.2,96,66.1,2,0
10/18/2017 20:20,30,69.3,46,64.6,76,66.5,2,0
10/18/2017 20:25,30,68.9,45,64.3,75,66.1,2,0
10/18/2017 20:30,32,68.9,49,64.2,81,66,2,0
10/18/2017 20:35,35,68.8,52,64.1,87,66,2,0
10/18/2017 20:40,30,69.3,46,64.7,76,66.5,2,0
10/18/2017 20:45,31,69.7,47,65,78,66.9,2,0
10/18/2017 20:50,32,69.9,48,65.3,80,67.2,2,0
10/18/2017 20:55,29,69.5,45,64.8,74,66.6,2,0
10/18/2017 21:00,31,69.5,48,64.9,79,66.7,2,0
10/18/2017 21:05,27,69.3,43,64.7,70,66.5,2,0
10/18/2017 21:10,31,69,47,64.4,78,66.3,2,0
10/18/2017 21:15,27,68.2,43,63.5,70,65.3,2,0
10/18/2017 21:20,26,68.4,42,63.7,68,65.5,2,0
10/18/2017 21:25,30,69,47,64.3,77,66.1,2,0
10/18/2017 21:30,24,69.4,40,64.8,64,66.5,2,0
10/18/2017 21:35,31,67.8,47,63.1,78,65,2,0
10/18/2017 21:40,30,68.6,47,63.9,77,65.7,2,0
10/18/2017 21:45,25,69.1,41,64.5,66,66.2,2,0
10/18/2017 21:50,24,69.2,40,64.6,64,66.3,2,0
10/18/2017 21:55,18,69.4,34,64.8,52,66.4,2,0
10/18/2017 22:00,25,69.7,41,65.2,66,66.9,2,0
10/18/2017 22:05,23,69.6,39,65,62,66.7,2,0
10/18/2017 22:10,24,69.5,39,64.9,63,66.7,2,0
10/18/2017 22:15,18,69.6,33,65,51,66.6,2,0
10/18/2017 22:20,22,69.6,38,65,60,66.7,2,0
10/18/2017 22:25,21,69.6,37,65,58,66.7,2,0
10/18/2017 22:30,19,69.6,35,65,54,66.6,2,0
10/18/2017 22:35,20,69,35,64.4,55,66.1,2,0
10/18/2017 22:40,17,69.3,32,64.7,49,66.3,2,0
10/18/2017 22:45,22,68.8,38,64.2,60,65.9,2,0
10/18/2017 22:50,17,69,33,64.4,50,66,2,0
10/18/2017 22:55,13,69.3,28,64.7,41,66.1,2,0
10/18/2017 23:00,15,69.2,31,64.6,46,66.1,2,0
10/18/2017 23:05,16,69.1,32,64.5,48,66,2,0
10/18/2017 23:10,22,69.2,38,64.6,60,66.3,2,0
10/18/2017 23:15,16,69.2,32,64.6,48,66.1,2,0
10/18/2017 23:20,13,69.3,29,64.7,42,66.2,2,0
10/18/2017 23:25,14,69.4,29,64.8,43,66.3,2,0
10/18/2017 23:30,14,69.4,29,64.8,43,66.3,2,0
10/18/2017 23:35,12,69.2,27,64.5,39,66,2,0
10/18/2017 23:40,15,69.4,31,64.8,46,66.3,2,0
10/18/2017 23:45,15,69.4,31,64.8,46,66.3,2,0
10/18/2017 23:50,10,69.4,26,64.8,36,66.1,2,0
10/18/2017 23:55,17,69.4,32,64.8,49,66.4,2,0
10/19/2017 0:00,12,69.3,27,64.7,39,66.2,2,0
10/19/2017 0:05,15,69.3,30,64.7,45,66.2,2,0
10/19/2017 0:10,9,69.4,24,64.8,33,66.1,2,0
10/19/2017 0:15,9,69.5,24,64.9,33,66.1,2,0
10/19/2017 0:20,7,69.5,22,64.9,29,66,2,0
10/19/2017 0:25,9,69.5,25,64.9,34,66.1,2,0
10/19/2017 0:30,9,69.4,24,64.8,33,66.1,2,0
10/19/2017 0:35,11,69.2,27,64.5,38,65.9,2,0
10/19/2017 0:40,6,69.1,21,64.5,27,65.5,2,0
10/19/2017 0:45,7,69.2,23,64.6,30,65.7,2,0
10/19/2017 0:50,7,69.3,22,64.7,29,65.8,2,0
10/19/2017 0:55,9,69.4,24,64.8,33,66.1,2,0
10/19/2017 1:00,7,69.5,23,64.9,30,66,2,0
10/19/2017 1:05,6,68.9,21,64.3,27,65.3,2,0
10/19/2017 1:10,6,69.1,21,64.5,27,65.5,2,0
10/19/2017 1:15,9,68.7,24,64,33,65.3,2,0
10/19/2017 1:20,13,68.9,21,64.3,34,66.1,2,0
10/19/2017 1:25,7,69.1,22,64.5,29,65.6,2,0
10/19/2017 1:30,10,69.3,25,64.7,35,66,2,0
10/19/2017 1:35,11,69,27,64.4,38,65.7,2,0
10/19/2017 1:40,6,69,22,64.4,28,65.3,2,0
10/19/2017 1:45,7,69.2,23,64.6,30,65.7,2,0
10/19/2017 1:50,12,69.3,21,64.7,33,66.4,2,0
10/19/2017 1:55,7,69.1,22,64.5,29,65.6,2,0
10/19/2017 2:00,8,69.3,23,64.7,31,65.8,2,0
10/19/2017 2:05,10,69.4,26,64.8,36,66.1,2,0
10/19/2017 2:10,10,69.2,25,64.5,35,65.9,2,0
10/19/2017 2:15,8,69.2,23,64.6,31,65.8,2,0
10/19/2017 2:20,10,69.3,25,64.7,35,66.1,2,0
10/19/2017 2:25,6,69.4,21,64.8,27,65.8,2,0
10/19/2017 2:30,11,69.2,26,64.6,37,66,2,0
10/19/2017 2:35,10,69.1,25,64.5,35,65.8,2,0
10/19/2017 2:40,7,69.2,22,64.6,29,65.7,2,0
10/19/2017 2:45,8,69.2,24,64.5,32,65.7,2,0
10/19/2017 2:50,12,69.1,28,64.5,40,65.9,2,0
10/19/2017 2:55,8,69,24,64.4,32,65.5,2,0
10/19/2017 3:00,8,69.3,24,64.7,32,65.8,2,0
10/19/2017 3:05,9,69.4,24,64.8,33,66,2,0
10/19/2017 3:10,9,69.4,24,64.8,33,66.1,2,0
10/19/2017 3:15,7,69.4,23,64.8,30,65.9,2,0
10/19/2017 3:20,10,69,26,64.4,36,65.7,2,0
10/19/2017 3:25,9,69.2,24,64.6,33,65.9,2,0
10/19/2017 3:30,12,69.3,28,64.7,40,66.1,2,0
10/19/2017 3:35,14,69.5,30,64.9,44,66.4,2,0
10/19/2017 3:40,11,69.5,26,64.9,37,66.3,2,0
10/19/2017 3:45,14,69.2,30,64.6,44,66.1,2,0
10/19/2017 3:50,14,69.6,29,65,43,66.5,2,0
10/19/2017 3:55,12,69.5,28,65,40,66.3,2,0
10/19/2017 4:00,13,69.5,29,64.9,42,66.3,2,0
10/19/2017 4:05,18,69.4,34,64.8,52,66.4,2,0
10/19/2017 4:10,20,69.3,37,64.7,57,66.3,2,0
10/19/2017 4:15,20,69.4,36,64.8,56,66.5,2,0
10/19/2017 4:20,21,69.7,37,65.1,58,66.7,2,0
10/19/2017 4:25,31,69,47,64.4,78,66.2,2,0
10/19/2017 4:30,29,70.1,45,65.5,74,67.3,2,0
10/19/2017 4:35,35,69.5,53,64.9,88,66.7,2,0
10/19/2017 4:40,33,70,51,65.5,84,67.3,2,0
10/19/2017 4:45,36,70.8,54,66.4,90,68.2,2,0
10/19/2017 4:50,41,69.9,59,65.4,100,67.2,2,0
10/19/2017 4:55,35,70.2,53,65.7,88,67.5,2,0
10/19/2017 5:00,40,70.3,58,65.8,98,67.7,2,0
10/19/2017 5:05,36,69.9,54,65.4,90,67.2,2,0
10/19/2017 5:10,47,70,67,65.4,114,67.3,2,0
10/19/2017 5:15,40,69.8,58,65.3,98,67.2,2,0
10/19/2017 5:20,60,69.9,80,65.3,140,67.3,2,0
10/19/2017 5:25,51,68.7,71,64,122,66,2,0
10/19/2017 5:30,60,69.4,81,64.8,141,66.7,2,0
10/19/2017 5:35,56,68.8,77,64,133,66,2,0
10/19/2017 5:40,63,69.1,85,64.3,148,66.4,2,0
10/19/2017 5:45,75,68.6,98,63.9,173,65.9,2,0
10/19/2017 5:50,68,68.4,90,63.6,158,65.7,2,0
10/19/2017 5:55,64,67.8,86,62.9,150,65,2,0
10/19/2017 6:00,49,68.5,68,63.7,117,65.7,2,0
10/19/2017 6:05,63,67.6,84,62.7,147,64.8,2,0
10/19/2017 6:10,60,66.3,82,61.3,142,63.4,2,0
10/19/2017 6:15,65,65.6,87,60.6,152,62.7,2,0
10/19/2017 6:20,68,67.4,90,62.5,158,64.6,2,0
10/19/2017 6:25,63,68,85,63.1,148,65.2,2,0
10/19/2017 6:30,69,68.1,91,63.2,160,65.3,2,0
10/19/2017 6:35,66,68.4,88,63.5,154,65.6,2,0
10/19/2017 6:40,63,67.6,85,62.7,148,64.8,2,0
10/19/2017 6:45,69,66.6,90,61.6,159,63.8,2,0
10/19/2017 6:50,68,66.9,89,61.9,157,64.1,2,0
10/19/2017 6:55,74,67.2,95,62.3,169,64.5,2,0
10/19/2017 7:00,77,66.4,99,61.4,176,63.6,2,0
10/19/2017 7:05,72,66.4,95,61.5,167,63.6,2,0
10/19/2017 7:10,64,66.2,86,61.1,150,63.3,2,0
10/19/2017 7:15,82,66.3,104,61.4,186,63.6,2,0
10/19/2017 7:20,82,66.4,106,61.4,188,63.6,2,0
10/19/2017 7:25,85,65.6,108,60.5,193,62.8,2,0
10/19/2017 7:30,92,66.5,115,61.5,207,63.7,2,0
10/19/2017 7:35,92,67.4,116,62.5,208,64.6,2,0
10/19/2017 7:40,94,66,118,61,212,63.2,2,0
10/19/2017 7:45,90,66.9,114,62,204,64.2,2,0
10/19/2017 7:50,95,67.9,118,63.1,213,65.2,2,0
10/19/2017 7:55,83,68.8,105,64.1,188,66.2,2,0
10/19/2017 8:00,86,68.6,109,63.8,195,65.9,2,0
10/19/2017 8:05,89,68.8,111,64.1,200,66.2,2,0
10/19/2017 8:10,88,67.1,112,62.2,200,64.3,2,0
10/19/2017 8:15,93,66,117,61.1,210,63.3,2,0
10/19/2017 8:20,90,66.5,113,61.5,203,63.7,2,0
10/19/2017 8:25,86,65.8,108,60.8,194,63,2,0
10/19/2017 8:30,94,66.6,118,61.7,212,63.9,2,0
10/19/2017 8:35,73,67.5,94,62.6,167,64.8,2,0
10/19/2017 8:40,86,66.9,108,62,194,64.2,2,0
10/19/2017 8:45,81,67.2,103,62.3,184,64.4,2,0
10/19/2017 8:50,91,66,114,61.1,205,63.3,2,0
10/19/2017 8:55,82,66,104,61,186,63.2,2,0
10/19/2017 9:00,82,66.1,106,61.1,188,63.3,2,0
10/19/2017 9:05,70,64.9,91,59.9,161,62.1,2,0
10/19/2017 9:10,80,66.3,101,61.4,181,63.6,2,0
10/19/2017 9:15,72,65.3,93,60.4,165,62.5,2,0
10/19/2017 9:20,73,65,94,59.9,167,62.1,2,0
10/19/2017 9:25,70,66.5,90,61.6,160,63.7,2,0
10/19/2017 9:30,74,64.2,94,59,168,61.3,2,0
10/19/2017 9:35,75,64.9,96,59.9,171,62.1,2,0
10/19/2017 9:40,70,65.2,92,60.2,162,62.4,2,0
10/19/2017 9:45,78,65.6,99,60.6,177,62.8,2,0
10/19/2017 9:50,73,65.8,93,60.8,166,63,2,0
10/19/2017 9:55,72,66.3,93,61.4,165,63.6,2,0
10/19/2017 10:00,69,64.8,89,59.8,158,62,2,0
10/19/2017 10:05,65,65.5,85,60.6,150,62.7,2,0
10/19/2017 10:10,57,64.2,77,59.3,134,61.4,2,0
10/19/2017 10:15,58,66.6,77,61.9,135,63.9,2,0
10/19/2017 10:20,59,67.3,78,62.6,137,64.6,2,0
10/19/2017 10:25,65,67.5,84,62.8,149,64.9,2,0
10/19/2017 10:30,63,67.1,81,62.4,144,64.4,2,0
10/19/2017 10:35,60,66.4,78,61.6,138,63.7,2,0
10/19/2017 10:40,65,67,83,62.2,148,64.3,2,0
10/19/2017 10:45,71,66.7,91,61.9,162,64,2,0
10/19/2017 10:50,64,66,84,61.1,148,63.2,2,0
10/19/2017 10:55,67,66.2,88,61.4,155,63.5,2,0
10/19/2017 11:00,59,67.6,77,62.9,136,65,2,0
10/19/2017 11:05,69,67.6,89,62.8,158,64.9,2,0
10/19/2017 11:10,67,67.5,87,62.7,154,64.8,2,0
10/19/2017 11:15,72,67,90,62.2,162,64.3,2,0
10/19/2017 11:20,64,67.7,82,63,146,65,2,0
10/19/2017 11:25,54,67.7,72,63,126,65,2,0
10/19/2017 11:30,68,67.3,89,62.6,157,64.7,2,0
10/19/2017 11:35,48,67.2,65,62.4,113,64.4,2,0
10/19/2017 11:40,59,67.3,77,62.5,136,64.6,2,0
10/19/2017 11:45,62,67.7,81,63,143,65.1,2,0
10/19/2017 11:50,66,69.2,84,64.7,150,66.7,2,0
10/19/2017 11:55,58,69.7,76,65.2,134,67.2,2,0
10/19/2017 12:00,50,69.9,68,65.4,118,67.3,2,0
10/19/2017 12:05,58,68,76,63.3,134,65.3,2,0
10/19/2017 12:10,61,68.9,80,64.3,141,66.3,2,0
10/19/2017 12:15,57,67.1,75,62.4,132,64.4,2,0
10/19/2017 12:20,60,67,78,62.2,138,64.3,2,0
10/19/2017 12:25,54,67.5,72,62.8,126,64.8,2,0
10/19/2017 12:30,49,67.4,66,62.6,115,64.6,2,0
10/19/2017 12:35,56,66.9,74,62.2,130,64.2,2,0
10/19/2017 12:40,51,66.1,69,61.2,120,63.3,2,0
10/19/2017 12:45,64,66.5,83,61.6,147,63.7,2,0
10/19/2017 12:50,63,66.4,82,61.4,145,63.6,2,0
10/19/2017 12:55,59,66.1,78,61.2,137,63.3,2,0
10/19/2017 13:00,56,64.4,74,59.4,130,61.6,2,0
10/19/2017 13:05,53,66.8,71,62,124,64.1,2,0
10/19/2017 13:10,57,67,75,62.3,132,64.3,2,0
10/19/2017 13:15,55,66.6,72,61.8,127,63.9,2,0
10/19/2017 13:20,47,67.7,64,63,111,65,2,0
10/19/2017 13:25,50,67.2,67,62.5,117,64.5,2,0
10/19/2017 13:30,46,67.4,64,62.6,110,64.6,2,0
10/19/2017 13:35,56,67.2,73,62.5,129,64.5,2,0
10/19/2017 13:40,54,66.6,73,61.8,127,63.9,2,0
10/19/2017 13:45,48,67.4,65,62.7,113,64.7,2,0
10/19/2017 13:50,55,65.4,73,60.6,128,62.7,2,0
10/19/2017 13:55,42,66.8,59,62,101,64,2,0
10/19/2017 14:00,41,66.4,59,61.6,100,63.6,2,0
10/19/2017 14:05,50,66.1,69,61.3,119,63.3,2,0
10/19/2017 14:10,34,67.6,50,62.8,84,64.8,2,0
10/19/2017 14:15,47,67.4,64,62.6,111,64.7,2,0
10/19/2017 14:20,42,68,59,63.3,101,65.2,2,0
10/19/2017 14:25,53,68.5,71,63.9,124,65.8,2,0
10/19/2017 14:30,63,66.9,82,62.1,145,64.2,2,0
10/19/2017 14:35,52,68.4,70,63.7,122,65.7,2,0
10/19/2017 14:40,61,67.5,79,62.8,140,64.9,2,0
10/19/2017 14:45,61,66.4,79,61.6,140,63.7,2,0
10/19/2017 14:50,64,67.3,83,62.6,147,64.7,2,0
10/19/2017 14:55,61,66.1,80,61.3,141,63.4,2,0
10/19/2017 15:00,55,66.9,73,62.1,128,64.2,2,0
10/19/2017 15:05,68,65.9,87,61,155,63.2,2,0
10/19/2017 15:10,69,67.3,88,62.5,157,64.6,2,0
10/19/2017 15:15,68,66.5,87,61.7,155,63.8,2,0
10/19/2017 15:20,71,67.1,92,62.2,163,64.3,2,0
10/19/2017 15:25,73,67.3,93,62.5,166,64.7,2,0
10/19/2017 15:30,70,65.8,90,60.9,160,63,2,0
10/19/2017 15:35,71,67.1,92,62.2,163,64.3,2,0
10/19/2017 15:40,76,59.9,97,54.3,173,56.8,2,0
10/19/2017 15:45,65,47.5,85,40.5,150,43.5,2,0
10/19/2017 15:50,68,45,88,37.7,156,40.9,2,0
10/19/2017 15:55,63,38.7,82,30.8,145,34.2,2,0
10/19/2017 16:00,69,36.7,88,28.5,157,32.1,2,0
10/19/2017 16:05,62,42.1,82,34.4,144,37.8,2,0
10/19/2017 16:10,57,41.9,76,34.3,133,37.5,2,0
10/19/2017 16:15,61,44,80,36.5,141,39.7,2,0
10/19/2017 16:20,58,39.5,76,31.6,134,35,2,0
10/19/2017 16:25,57,39.6,76,31.6,133,35,2,0
10/19/2017 16:30,44,36.3,62,28.1,106,31.5,2,0
10/19/2017 16:35,54,44.2,73,36.8,127,39.9,2,0
10/19/2017 16:40,50,48.2,69,41.1,119,44.1,2,0
10/19/2017 16:45,45,49,63,42.1,108,45,2,0
10/19/2017 16:50,48,51.5,66,44.8,114,47.6,2,0
10/19/2017 16:55,50,57.4,69,51.4,119,53.9,2,0
10/19/2017 17:00,54,60.4,73,54.8,127,57.2,2,0
10/19/2017 17:05,58,62.7,76,57.4,134,59.7,2,0
10/19/2017 17:10,56,63.4,76,58.1,132,60.3,2,0
10/19/2017 17:15,51,61.4,69,55.9,120,58.2,2,0
10/19/2017 17:20,60,59.5,78,53.8,138,56.3,2,0
10/19/2017 17:25,56,45,76,37.7,132,40.8,2,0
10/19/2017 17:30,42,36.2,59,28,101,31.4,2,0
10/19/2017 17:35,58,32.7,76,24,134,27.8,2,0
10/19/2017 17:40,63,31.7,83,23,146,26.7,2,0
10/19/2017 17:45,51,34.3,69,25.9,120,29.5,2,0
10/19/2017 17:50,55,41.1,74,33.5,129,36.7,2,0
10/19/2017 17:55,44,53.6,62,47.3,106,49.9,2,0
10/19/2017 18:00,59,59.9,79,54.3,138,56.7,2,0
10/19/2017 18:05,52,62.5,70,57.2,122,59.5,2,0
10/19/2017 18:10,37,65.5,54,60.5,91,62.6,2,0
10/19/2017 18:15,49,65.9,67,60.9,116,63,2,0
10/19/2017 18:20,44,64.7,63,59.6,107,61.7,2,0
10/19/2017 18:25,46,66,64,61.1,110,63.2,2,0
10/19/2017 18:30,45,65.8,63,60.9,108,63,2,0
10/19/2017 18:35,47,66.5,64,61.6,111,63.7,2,0
10/19/2017 18:40,55,66.1,74,61.2,129,63.3,2,0
10/19/2017 18:45,51,66.3,69,61.4,120,63.5,2,0
10/19/2017 18:50,45,65.5,63,60.6,108,62.6,2,0
10/19/2017 18:55,47,65,64,59.9,111,62.1,2,0
10/19/2017 19:00,46,66.2,63,61.3,109,63.4,2,0
10/19/2017 19:05,38,66.7,54,61.9,92,63.9,2,0
10/19/2017 19:10,42,66.4,59,61.6,101,63.6,2,0
10/19/2017 19:15,47,66.3,63,61.4,110,63.5,2,0
10/19/2017 19:20,37,67.1,54,62.3,91,64.3,2,0
10/19/2017 19:25,45,66.3,61,61.4,106,63.4,2,0
10/19/2017 19:30,41,66.3,59,61.4,100,63.4,2,0
10/19/2017 19:35,41,67.1,58,62.2,99,64.2,2,0
10/19/2017 19:40,41,68.2,59,63.4,100,65.4,2,0
10/19/2017 19:45,38,68.8,55,64.1,93,66,2,0
10/19/2017 19:50,44,67.7,61,62.8,105,64.8,2,0
10/19/2017 19:55,36,67.8,52,63,88,64.9,2,0
10/19/2017 20:00,37,68.1,53,63.3,90,65.3,2,0
10/19/2017 20:05,29,68.9,45,64.2,74,66,2,0
10/19/2017 20:10,32,68.7,48,64.1,80,65.9,2,0
10/19/2017 20:15,35,68.2,51,63.4,86,65.3,2,0
10/19/2017 20:20,31,68.6,47,63.9,78,65.8,2,0
10/19/2017 20:25,33,68.8,49,64.1,82,65.9,2,0
10/19/2017 20:30,35,69.1,52,64.4,87,66.3,2,0
10/19/2017 20:35,34,68.9,50,64.3,84,66.1,2,0
10/19/2017 20:40,30,69.1,46,64.4,76,66.2,2,0
10/19/2017 20:45,33,68.8,50,64.2,83,66,2,0
10/19/2017 20:50,36,69.6,52,65,88,66.8,2,0
10/19/2017 20:55,35,69,52,64.4,87,66.2,2,0
10/19/2017 21:00,31,68.9,47,64.2,78,66.1,2,0
10/19/2017 21:05,31,68.5,48,63.9,79,65.7,2,0
10/19/2017 21:10,35,69.1,51,64.5,86,66.4,2,0
10/19/2017 21:15,24,68.8,40,64.2,64,65.9,2,0
10/19/2017 21:20,31,69.1,48,64.5,79,66.3,2,0
10/19/2017 21:25,36,69.3,53,64.7,89,66.6,2,0
10/19/2017 21:30,36,69,53,64.3,89,66.2,2,0
10/19/2017 21:35,34,69.1,50,64.4,84,66.3,2,0
10/19/2017 21:40,36,69,53,64.4,89,66.3,2,0
10/19/2017 21:45,34,69.6,51,65,85,66.8,2,0
10/19/2017 21:50,31,69.4,48,64.8,79,66.6,2,0
10/19/2017 21:55,28,69,44,64.4,72,66.2,2,0
10/19/2017 22:00,26,68.9,41,64.3,67,66.1,2,0
10/19/2017 22:05,23,69.1,39,64.5,62,66.2,2,0
10/19/2017 22:10,22,69.3,38,64.7,60,66.4,2,0
10/19/2017 22:15,24,69.3,40,64.7,64,66.5,2,0
10/19/2017 22:20,25,69.1,41,64.5,66,66.2,2,0
10/19/2017 22:25,19,69.2,34,64.6,53,66.3,2,0
10/19/2017 22:30,26,69.4,41,64.8,67,66.6,2,0
10/19/2017 22:35,21,63,37,57.6,58,59.6,2,0
10/19/2017 22:40,24,66.5,39,61.5,63,63.4,2,0
10/19/2017 22:45,24,68,40,63.2,64,65,2,0
10/19/2017 22:50,23,68.5,39,63.8,62,65.6,2,0
10/19/2017 22:55,23,69.1,38,64.4,61,66.2,2,0
10/19/2017 23:00,25,69.1,41,64.4,66,66.2,2,0
10/19/2017 23:05,22,69.3,38,64.7,60,66.4,2,0
10/19/2017 23:10,19,69.4,34,64.8,53,66.5,2,0
10/19/2017 23:15,23,68.4,39,63.7,62,65.5,2,0
10/19/2017 23:20,18,68.8,34,64.2,52,65.8,2,0
10/19/2017 23:25,17,68.8,33,64.2,50,65.7,2,0
10/19/2017 23:30,14,68.8,29,64.1,43,65.6,2,0
10/19/2017 23:35,22,68.4,37,63.7,59,65.5,2,0
10/19/2017 23:40,19,68.7,35,64.1,54,65.7,2,0
10/19/2017 23:45,16,68.6,31,64,47,65.6,2,0
10/19/2017 23:50,13,68.9,28,64.2,41,65.7,2,0
10/19/2017 23:55,18,68.5,34,63.8,52,65.4,2,0
10/20/2017 0:00,13,69.3,29,64.7,42,66.2,2,0
10/20/2017 0:05,13,68.9,28,64.3,41,65.7,2,0
10/20/2017 0:10,13,68.9,28,64.3,41,65.7,2,0
10/20/2017 0:15,11,69,26,64.4,37,65.8,2,0
10/20/2017 0:20,10,69.1,25,64.4,35,65.8,2,0
10/20/2017 0:25,11,69.1,26,64.5,37,65.8,2,0
10/20/2017 0:30,12,69.1,27,64.5,39,65.9,2,0
10/20/2017 0:35,13,68.5,28,63.8,41,65.3,2,0
10/20/2017 0:40,12,68.7,27,64.1,39,65.5,2,0
10/20/2017 0:45,9,69,24,64.3,33,65.6,2,0
10/20/2017 0:50,7,68.9,22,64.2,29,65.4,2,0
10/20/2017 0:55,9,68.9,24,64.3,33,65.5,2,0
10/20/2017 1:00,11,68.5,26,63.9,37,65.2,2,0
10/20/2017 1:05,7,68.9,23,64.3,30,65.4,2,0
10/20/2017 1:10,6,69,21,64.4,27,65.4,2,0
10/20/2017 1:15,8,69.1,23,64.5,31,65.7,2,0
10/20/2017 1:20,7,69.1,22,64.5,29,65.6,2,0
10/20/2017 1:25,6,69,21,64.3,27,65.3,2,0
10/20/2017 1:30,9,69,24,64.4,33,65.6,2,0
10/20/2017 1:35,10,69.1,25,64.4,35,65.8,2,0
10/20/2017 1:40,7,69,22,64.4,29,65.5,2,0
10/20/2017 1:45,5,69.2,20,64.5,25,65.5,2,0
10/20/2017 1:50,8,69,23,64.4,31,65.6,2,0
10/20/2017 1:55,7,69.2,22,64.5,29,65.7,2,0
10/20/2017 2:00,9,69.2,24,64.5,33,65.8,2,0
10/20/2017 2:05,9,69,24,64.4,33,65.7,2,0
10/20/2017 2:10,11,69.1,26,64.5,37,65.9,2,0
10/20/2017 2:15,7,69.3,22,64.7,29,65.8,2,0
10/20/2017 2:20,6,69.3,21,64.7,27,65.7,2,0
10/20/2017 2:25,9,69.3,24,64.7,33,66,2,0
10/20/2017 2:30,9,68.8,24,64.2,33,65.4,2,0
10/20/2017 2:35,10,69.1,25,64.5,35,65.8,2,0
10/20/2017 2:40,11,69,27,64.4,38,65.7,2,0
10/20/2017 2:45,11,69.3,27,64.7,38,66,2,0
10/20/2017 2:50,8,69.3,23,64.7,31,65.9,2,0
10/20/2017 2:55,8,69.4,23,64.8,31,66,2,0
10/20/2017 3:00,13,69.1,29,64.5,42,65.9,2,0
10/20/2017 3:05,9,69.1,25,64.5,34,65.7,2,0
10/20/2017 3:10,11,69.3,27,64.7,38,66,2,0
10/20/2017 3:15,11,69.2,27,64.6,38,66,2,0
10/20/2017 3:20,11,69.2,26,64.6,37,66,2,0
10/20/2017 3:25,12,69.1,28,64.5,40,65.9,2,0
10/20/2017 3:30,13,69.1,29,64.5,42,65.9,2,0
10/20/2017 3:35,9,69.2,24,64.5,33,65.8,2,0
10/20/2017 3:40,12,69.3,28,64.7,40,66,2,0
10/20/2017 3:45,17,69.4,33,64.8,50,66.4,2,0
10/20/2017 3:50,12,69.4,28,64.8,40,66.2,2,0
10/20/2017 3:55,17,68.9,33,64.3,50,65.9,2,0
10/20/2017 4:00,22,68.7,37,64,59,65.7,2,0
10/20/2017 4:05,16,68.4,32,63.8,48,65.3,2,0
10/20/2017 4:10,17,68.8,33,64.1,50,65.7,2,0
10/20/2017 4:15,20,69,36,64.4,56,66,2,0
10/20/2017 4:20,27,69.3,43,64.6,70,66.4,2,0
10/20/2017 4:25,22,69.3,38,64.7,60,66.4,2,0
10/20/2017 4:30,22,69.2,38,64.5,60,66.2,2,0
10/20/2017 4:35,32,69.8,49,65.3,81,67.1,2,0
10/20/2017 4:40,36,70.1,54,65.5,90,67.4,2,0
10/20/2017 4:45,35,69.8,53,65.2,88,67,2,0
10/20/2017 4:50,47,68.6,66,63.9,113,65.9,2,0
10/20/2017 4:55,41,69.1,59,64.4,100,66.3,2,0
10/20/2017 5:00,39,69.3,57,64.7,96,66.6,2,0
10/20/2017 5:05,39,69.6,58,65,97,66.9,2,0
10/20/2017 5:10,47,64.6,66,59,113,61.3,2,0
10/20/2017 5:15,38,65.6,56,60.5,94,62.6,2,0
10/20/2017 5:20,49,66.2,69,61.2,118,63.3,2,0
10/20/2017 5:25,49,67.5,69,62.6,118,64.6,2,0
10/20/2017 5:30,56,67.3,76,62.5,132,64.6,2,0
10/20/2017 5:35,59,67.4,80,62.6,139,64.6,2,0
10/20/2017 5:40,63,68,84,63.2,147,65.2,2,0
10/20/2017 5:45,56,68.7,77,63.9,133,65.9,2,0
10/20/2017 5:50,56,70.2,76,65.6,132,67.5,2,0
10/20/2017 5:55,60,68.8,81,64.1,141,66.1,2,0
10/20/2017 6:00,49,68.2,68,63.4,117,65.4,2,0
10/20/2017 6:05,58,67.8,79,63,137,65,2,0
10/20/2017 6:10,57,68,78,63.2,135,65.2,2,0
10/20/2017 6:15,54,66.4,74,61.5,128,63.6,2,0
10/20/2017 6:20,56,66.8,77,61.8,133,63.9,2,0
10/20/2017 6:25,66,66.3,87,61.3,153,63.5,2,0
10/20/2017 6:30,65,66.4,86,61.4,151,63.6,2,0
10/20/2017 6:35,56,65.8,76,60.8,132,62.9,2,0
10/20/2017 6:40,63,65.9,83,60.9,146,63.1,2,0
10/20/2017 6:45,78,66.6,100,61.6,178,63.8,2,0
10/20/2017 6:50,62,66.5,82,61.5,144,63.6,2,0
10/20/2017 6:55,65,65.7,87,60.6,152,62.8,2,0
10/20/2017 7:00,61,66.3,81,61.4,142,63.5,2,0
10/20/2017 7:05,70,66,90,61.1,160,63.2,2,0
10/20/2017 7:10,71,66.7,92,61.8,163,63.9,2,0
10/20/2017 7:15,80,66.7,103,61.7,183,63.9,2,0
10/20/2017 7:20,77,66.1,99,61.1,176,63.3,2,0
10/20/2017 7:25,75,65.8,98,60.8,173,63,2,0
10/20/2017 7:30,80,65.8,103,60.8,183,63,2,0
10/20/2017 7:35,78,65.8,101,60.8,179,63,2,0
10/20/2017 7:40,80,66.2,102,61.2,182,63.4,2,0
10/20/2017 7:45,85,67.1,109,62.2,194,64.4,2,0
10/20/2017 7:50,73,67.1,94,62.2,167,64.3,2,0
10/20/2017 7:55,83,67.1,105,62.2,188,64.3,2,0
10/20/2017 8:00,74,67.3,96,62.4,170,64.5,2,0
10/20/2017 8:05,78,67.2,102,62.3,180,64.5,2,0
10/20/2017 8:10,78,66.5,102,61.7,180,63.8,2,0
10/20/2017 8:15,75,66.2,98,61.3,173,63.4,2,0
10/20/2017 8:20,81,65.6,104,60.7,185,62.8,2,0
10/20/2017 8:25,74,67.1,96,62.3,170,64.4,2,0
10/20/2017 8:30,80,67.2,102,62.3,182,64.4,2,0
10/20/2017 8:35,78,67,100,62.1,178,64.3,2,0
10/20/2017 8:40,71,66.8,92,61.9,163,64,2,0
10/20/2017 8:45,88,66.8,110,61.9,198,64.1,2,0
10/20/2017 8:50,78,65,100,59.9,178,62.2,2,0
10/20/2017 8:55,81,66.2,102,61.2,183,63.5,2,0
10/20/2017 9:00,73,65.5,94,60.5,167,62.7,2,0
10/20/2017 9:05,67,66,87,60.9,154,63.1,2,0
10/20/2017 9:10,77,66.4,98,61.4,175,63.6,2,0
10/20/2017 9:15,68,66.1,89,61.2,157,63.3,2,0
10/20/2017 9:20,77,65.4,98,60.5,175,62.7,2,0
10/20/2017 9:25,73,66.5,94,61.6,167,63.8,2,0
10/20/2017 9:30,73,64.6,96,59.5,169,61.7,2,0
10/20/2017 9:35,65,64.3,85,59.2,150,61.4,2,0
10/20/2017 9:40,65,65.8,84,60.9,149,63,2,0
10/20/2017 9:45,57,65.2,78,60.2,135,62.3,2,0
10/20/2017 9:50,66,66.8,87,62,153,64,2,0
10/20/2017 9:55,61,66.9,80,62.1,141,64.2,2,0
10/20/2017 10:00,65,67.2,85,62.4,150,64.5,2,0
10/20/2017 10:05,62,68.3,81,63.6,143,65.6,2,0
10/20/2017 10:10,67,67.4,87,62.7,154,64.8,2,0
10/20/2017 10:15,69,67.3,89,62.5,158,64.6,2,0
10/20/2017 10:20,66,65.9,87,61,153,63.1,2,0
10/20/2017 10:25,64,66.1,84,61.3,148,63.4,2,0
10/20/2017 10:30,68,66.8,86,61.9,154,64,2,0
10/20/2017 10:35,53,65.8,72,60.9,125,63,2,0
10/20/2017 10:40,53,66.5,71,61.8,124,63.8,2,0
10/20/2017 10:45,69,67.9,89,63.3,158,65.3,2,0
10/20/2017 10:50,67,67.1,87,62.5,154,64.5,2,0
10/20/2017 10:55,66,68,85,63.4,151,65.4,2,0
10/20/2017 11:00,61,67.4,81,62.8,142,64.8,2,0
10/20/2017 11:05,63,68,80,63.3,143,65.4,2,0
10/20/2017 11:10,59,67.1,77,62.4,136,64.4,2,0
10/20/2017 11:15,58,68.4,77,63.8,135,65.8,2,0
10/20/2017 11:20,59,67.6,77,62.8,136,64.9,2,0
10/20/2017 11:25,60,68,78,63.3,138,65.4,2,0
10/20/2017 11:30,61,68.7,80,64,141,66,2,0
10/20/2017 11:35,53,66.5,72,61.7,125,63.7,2,0
10/20/2017 11:40,61,66.8,80,62,141,64.1,2,0
10/20/2017 11:45,60,66.2,78,61.4,138,63.5,2,0
10/20/2017 11:50,56,67.3,76,62.6,132,64.6,2,0
10/20/2017 11:55,56,67.5,76,62.8,132,64.8,2,0
10/20/2017 12:00,54,68.6,71,64.1,125,66,2,0
10/20/2017 12:05,50,68.7,68,64.1,118,66,2,0
10/20/2017 12:10,50,68.3,68,63.6,118,65.6,2,0
10/20/2017 12:15,59,68.7,77,64,136,66,2,0
10/20/2017 12:20,50,67.6,68,62.9,118,64.9,2,0
10/20/2017 12:25,59,66.4,79,61.7,138,63.7,2,0
10/20/2017 12:30,53,66.5,72,61.7,125,63.7,2,0
10/20/2017 12:35,57,67.4,75,62.6,132,64.7,2,0
10/20/2017 12:40,54,68.6,71,63.9,125,65.9,2,0
10/20/2017 12:45,64,69.1,83,64.5,147,66.5,2,0
10/20/2017 12:50,48,67.6,65,62.9,113,64.9,2,0
10/20/2017 12:55,48,68.2,66,63.6,114,65.5,2,0
10/20/2017 13:00,50,68.3,67,63.6,117,65.6,2,0
10/20/2017 13:05,50,68,67,63.3,117,65.3,2,0
10/20/2017 13:10,51,66.1,68,61.2,119,63.3,2,0
10/20/2017 13:15,61,65.2,79,60.2,140,62.4,2,0
10/20/2017 13:20,44,66.9,61,62.1,105,64.1,2,0
10/20/2017 13:25,54,67.5,72,62.6,126,64.7,2,0
10/20/2017 13:30,52,66.6,70,61.7,122,63.8,2,0
10/20/2017 13:35,53,66.3,71,61.4,124,63.5,2,0
10/20/2017 13:40,52,67.1,70,62.3,122,64.4,2,0
10/20/2017 13:45,50,67.8,68,63.1,118,65,2,0
10/20/2017 13:50,51,67.7,70,63,121,65,2,0
10/20/2017 13:55,47,66.9,64,62.1,111,64.1,2,0
10/20/2017 14:00,57,67.4,75,62.7,132,64.8,2,0
10/20/2017 14:05,55,67,74,62.2,129,64.3,2,0
10/20/2017 14:10,51,66.4,69,61.6,120,63.6,2,0
10/20/2017 14:15,60,66,79,61.1,139,63.2,2,0
10/20/2017 14:20,51,67.1,68,62.3,119,64.4,2,0
10/20/2017 14:25,56,66.3,75,61.4,131,63.5,2,0
10/20/2017 14:30,55,66.5,74,61.6,129,63.7,2,0
10/20/2017 14:35,55,67.9,74,63,129,65.1,2,0
10/20/2017 14:40,59,68,77,63.1,136,65.2,2,0
10/20/2017 14:45,59,68.4,77,63.7,136,65.7,2,0
10/20/2017 14:50,56,68.3,74,63.6,130,65.6,2,0
10/20/2017 14:55,51,68,69,63.2,120,65.2,2,0
10/20/2017 15:00,63,68.1,82,63.3,145,65.4,2,0
10/20/2017 15:05,58,67.3,76,62.4,134,64.6,2,0
10/20/2017 15:10,54,66.7,72,61.8,126,63.9,2,0
10/20/2017 15:15,58,67.6,77,62.7,135,64.8,2,0
10/20/2017 15:20,51,67.1,69,62.3,120,64.4,2,0
10/20/2017 15:25,65,67.5,86,62.7,151,64.7,2,0
10/20/2017 15:30,64,67.8,83,63,147,65.1,2,0
10/20/2017 15:35,57,67.5,75,62.7,132,64.8,2,0
10/20/2017 15:40,79,67.7,100,62.8,179,65,2,0
10/20/2017 15:45,60,68,77,63.3,137,65.4,2,0
10/20/2017 15:50,67,68.1,86,63.4,153,65.5,2,0
10/20/2017 15:55,62,67.6,81,62.8,143,64.9,2,0
10/20/2017 16:00,64,67.6,83,62.8,147,64.9,2,0
10/20/2017 16:05,63,67.2,82,62.4,145,64.4,2,0
10/20/2017 16:10,67,67.1,87,62.2,154,64.3,2,0
10/20/2017 16:15,64,67.7,84,62.9,148,65,2,0
10/20/2017 16:20,69,67.9,88,63.1,157,65.2,2,0
10/20/2017 16:25,64,68.4,82,63.6,146,65.7,2,0
10/20/2017 16:30,71,67.7,89,62.9,160,65,2,0
10/20/2017 16:35,66,65.5,85,60.4,151,62.6,2,0
10/20/2017 16:40,63,62.9,81,57.6,144,59.9,2,0
10/20/2017 16:45,59,65,78,60,137,62.1,2,0
10/20/2017 16:50,66,65.9,86,60.9,152,63.1,2,0
10/20/2017 16:55,59,66.3,76,61.4,135,63.6,2,0
10/20/2017 17:00,57,67.5,76,62.6,133,64.7,2,0
10/20/2017 17:05,47,67.1,65,62.3,112,64.3,2,0
10/20/2017 17:10,59,67.6,77,62.7,136,64.8,2,0
10/20/2017 17:15,50,67.4,68,62.6,118,64.6,2,0
10/20/2017 17:20,50,67.5,68,62.6,118,64.7,2,0
10/20/2017 17:25,52,66.6,70,61.7,122,63.8,2,0
10/20/2017 17:30,53,66.8,71,62,124,64,2,0
10/20/2017 17:35,56,67.5,74,62.6,130,64.7,2,0
10/20/2017 17:40,48,68,66,63.2,114,65.2,2,0
10/20/2017 17:45,50,66.6,67,61.7,117,63.8,2,0
10/20/2017 17:50,47,67.7,65,62.9,112,64.9,2,0
10/20/2017 17:55,49,67.1,67,62.3,116,64.4,2,0
10/20/2017 18:00,52,68.3,70,63.6,122,65.6,2,0
10/20/2017 18:05,69,68.3,89,63.6,158,65.7,2,0
10/20/2017 18:10,51,67.7,69,62.9,120,64.9,2,0
10/20/2017 18:15,58,67.9,76,63.2,134,65.2,2,0
10/20/2017 18:20,65,68.1,85,63.3,150,65.4,2,0
10/20/2017 18:25,61,68.1,80,63.3,141,65.4,2,0
10/20/2017 18:30,59,69,76,64.3,135,66.4,2,0
10/20/2017 18:35,61,68,80,63.2,141,65.3,2,0
10/20/2017 18:40,62,67.6,81,62.7,143,64.8,2,0
10/20/2017 18:45,59,67.8,76,63,135,65.1,2,0
10/20/2017 18:50,53,67.2,71,62.3,124,64.4,2,0
10/20/2017 18:55,53,67.5,69,62.6,122,64.7,2,0
10/20/2017 19:00,45,66.9,63,62,108,64,2,0
10/20/2017 19:05,45,67.6,62,62.7,107,64.8,2,0
10/20/2017 19:10,52,67.6,69,62.8,121,64.9,2,0
10/20/2017 19:15,46,67.3,64,62.5,110,64.5,2,0
10/20/2017 19:20,57,67.1,75,62.3,132,64.4,2,0
10/20/2017 19:25,55,66.9,73,62.1,128,64.1,2,0
10/20/2017 19:30,49,67,66,62.2,115,64.2,2,0
10/20/2017 19:35,50,67.9,67,63.2,117,65.2,2,0
10/20/2017 19:40,41,67.7,58,62.9,99,64.9,2,0
10/20/2017 19:45,48,68.2,66,63.5,114,65.5,2,0
10/20/2017 19:50,41,68.3,59,63.6,100,65.6,2,0
10/20/2017 19:55,43,69,61,64.4,104,66.3,2,0
10/20/2017 20:00,36,68.5,52,63.9,88,65.8,2,0
10/20/2017 20:05,36,68.5,52,63.9,88,65.8,2,0
10/20/2017 20:10,39,69.4,56,64.8,95,66.7,2,0
10/20/2017 20:15,35,69.1,51,64.5,86,66.4,2,0
10/20/2017 20:20,28,68.9,45,64.3,73,66,2,0
10/20/2017 20:25,35,68.9,52,64.2,87,66.1,2,0
10/20/2017 20:30,30,68.7,47,64,77,65.8,2,0
10/20/2017 20:35,30,69,46,64.3,76,66.2,2,0
10/20/2017 20:40,30,69.5,47,64.9,77,66.7,2,0
10/20/2017 20:45,30,69.2,46,64.7,76,66.5,2,0
10/20/2017 20:50,23,69.3,39,64.7,62,66.4,2,0
10/20/2017 20:55,30,68.2,47,63.5,77,65.3,2,0
10/20/2017 21:00,35,67.3,51,62.5,86,64.5,2,0
10/20/2017 21:05,28,68.1,44,63.4,72,65.2,2,0
10/20/2017 21:10,34,68.6,51,63.9,85,65.8,2,0
10/20/2017 21:15,29,68.4,45,63.7,74,65.5,2,0
10/20/2017 21:20,24,69.2,40,64.6,64,66.3,2,0
10/20/2017 21:25,23,69.2,39,64.6,62,66.3,2,0
10/20/2017 21:30,26,69.6,42,65,68,66.8,2,0
10/20/2017 21:35,28,69.5,43,65,71,66.8,2,0
10/20/2017 21:40,27,69.4,43,64.8,70,66.6,2,0
10/20/2017 21:45,26,69.5,42,64.9,68,66.6,2,0
10/20/2017 21:50,25,69.6,41,65,66,66.7,2,0
10/20/2017 21:55,27,69.5,44,64.9,71,66.7,2,0
10/20/2017 22:00,22,69.5,38,64.9,60,66.6,2,0
10/20/2017 22:05,29,69.6,45,65,74,66.8,2,0
10/20/2017 22:10,29,69.5,45,64.9,74,66.7,2,0
10/20/2017 22:15,29,69.4,45,64.8,74,66.6,2,0
10/20/2017 22:20,31,69.9,48,65.3,79,67.1,2,0
10/20/2017 22:25,25,69.7,41,65.1,66,66.9,2,0
10/20/2017 22:30,28,69.3,45,64.7,73,66.4,2,0
10/20/2017 22:35,26,69.3,42,64.7,68,66.5,2,0
10/20/2017 22:40,36,69.3,53,64.6,89,66.5,2,0
10/20/2017 22:45,29,69.5,44,64.8,73,66.7,2,0
10/20/2017 22:50,27,70,42,65.4,69,67.2,2,0
10/20/2017 22:55,26,69.8,42,65.2,68,66.9,2,0
10/20/2017 23:00,26,69.3,41,64.6,67,66.4,2,0
10/20/2017 23:05,21,69.4,37,64.8,58,66.5,2,0
10/20/2017 23:10,20,69.3,35,64.7,55,66.4,2,0
10/20/2017 23:15,24,69.1,40,64.5,64,66.2,2,0
10/20/2017 23:20,27,68.9,44,64.3,71,66.1,2,0
10/20/2017 23:25,29,68.9,45,64.2,74,66,2,0
10/20/2017 23:30,30,68.7,45,64.1,75,66,2,0
10/20/2017 23:35,28,68.8,44,64.2,72,66,2,0
10/20/2017 23:40,27,68.5,43,63.9,70,65.7,2,0
10/20/2017 23:45,22,68.5,38,63.8,60,65.5,2,0
10/20/2017 23:50,24,68.7,40,64.1,64,65.8,2,0
10/20/2017 23:55,18,69,33,64.4,51,66,2,0
10/21/2017 0:00,18,69.3,33,64.7,51,66.4,2,0
10/21/2017 0:05,20,68.9,35,64.2,55,65.9,2,0
10/21/2017 0:10,19,69,35,64.3,54,66,2,0
10/21/2017 0:15,22,69.1,38,64.4,60,66.1,2,0
10/21/2017 0:20,11,68.9,27,64.2,38,65.6,2,0
10/21/2017 0:25,17,69.2,32,64.5,49,66.1,2,0
10/21/2017 0:30,12,69.3,27,64.7,39,66.1,2,0
10/21/2017 0:35,15,69.1,30,64.5,45,66,2,0
10/21/2017 0:40,9,69.2,24,64.6,33,65.9,2,0
10/21/2017 0:45,13,69.2,29,64.6,42,66,2,0
10/21/2017 0:50,13,69.2,29,64.5,42,66,2,0
10/21/2017 0:55,10,69.3,25,64.7,35,66,2,0
10/21/2017 1:00,9,69.4,24,64.8,33,66,2,0
10/21/2017 1:05,9,69,24,64.4,33,65.6,2,0
10/21/2017 1:10,8,69.1,23,64.4,31,65.6,2,0
10/21/2017 1:15,14,68.9,29,64.2,43,65.7,2,0
10/21/2017 1:20,13,68.8,28,64.2,41,65.6,2,0
10/21/2017 1:25,12,69,27,64.4,39,65.8,2,0
10/21/2017 1:30,11,69.2,26,64.6,37,66,2,0
10/21/2017 1:35,12,69.2,27,64.6,39,66,2,0
10/21/2017 1:40,8,69.3,23,64.7,31,65.9,2,0
10/21/2017 1:45,8,69.4,23,64.8,31,66,2,0
10/21/2017 1:50,6,69.4,21,64.8,27,65.8,2,0
10/21/2017 1:55,11,69.2,27,64.6,38,65.9,2,0
10/21/2017 2:00,6,69.3,21,64.7,27,65.8,2,0
10/21/2017 2:05,13,69.1,28,64.4,41,65.9,2,0
10/21/2017 2:10,9,69.1,24,64.5,33,65.8,2,0
10/21/2017 2:15,10,69.2,25,64.6,35,65.9,2,0
10/21/2017 2:20,10,69.1,26,64.5,36,65.7,2,0
10/21/2017 2:25,11,69.2,21,64.6,32,66.2,2,0
10/21/2017 2:30,5,69.3,20,64.7,25,65.6,2,0
10/21/2017 2:35,10,69.3,25,64.7,35,66.1,2,0
10/21/2017 2:40,6,69.3,22,64.7,28,65.7,2,0
10/21/2017 2:45,8,69.3,24,64.7,32,65.8,2,0
10/21/2017 2:50,6,69.1,21,64.5,27,65.5,2,0
10/21/2017 2:55,10,69.1,25,64.5,35,65.8,2,0
10/21/2017 3:00,10,69,26,64.4,36,65.7,2,0
10/21/2017 3:05,9,69.3,24,64.7,33,65.9,2,0
10/21/2017 3:10,8,69.3,23,64.7,31,65.9,2,0
10/21/2017 3:15,9,69,24,64.4,33,65.6,2,0
10/21/2017 3:20,12,69.2,21,64.6,33,66.3,2,0
10/21/2017 3:25,8,69.3,23,64.7,31,65.8,2,0
10/21/2017 3:30,10,69.4,26,64.7,36,66,2,0
10/21/2017 3:35,6,69.3,21,64.7,27,65.7,2,0
10/21/2017 3:40,9,69.3,25,64.7,34,65.9,2,0
10/21/2017 3:45,7,69.4,22,64.8,29,65.9,2,0
10/21/2017 3:50,9,69.3,25,64.7,34,66,2,0
10/21/2017 3:55,8,69.3,23,64.7,31,65.9,2,0
10/21/2017 4:00,6,69.3,21,64.7,27,65.7,2,0
10/21/2017 4:05,7,69.3,23,64.7,30,65.8,2,0
10/21/2017 4:10,11,69.2,26,64.6,37,66,2,0
10/21/2017 4:15,9,69.2,24,64.5,33,65.8,2,0
10/21/2017 4:20,11,69.3,26,64.7,37,66,2,0
10/21/2017 4:25,10,69.3,25,64.7,35,66.1,2,0
10/21/2017 4:30,11,69.3,26,64.7,37,66.1,2,0
10/21/2017 4:35,16,69.3,31,64.7,47,66.3,2,0
10/21/2017 4:40,19,69.3,36,64.7,55,66.3,2,0
10/21/2017 4:45,17,69.2,33,64.6,50,66.2,2,0
10/21/2017 4:50,14,69.3,29,64.7,43,66.2,2,0
10/21/2017 4:55,16,69.3,31,64.7,47,66.2,2,0
10/21/2017 5:00,21,69.3,37,64.7,58,66.3,2,0
10/21/2017 5:05,18,69.1,33,64.5,51,66.1,2,0
10/21/2017 5:10,13,69,29,64.4,42,65.8,2,0
10/21/2017 5:15,17,69.2,33,64.5,50,66.1,2,0
10/21/2017 5:20,16,69.2,32,64.5,48,66.1,2,0
10/21/2017 5:25,18,69.1,34,64.5,52,66.1,2,0
10/21/2017 5:30,17,69.1,33,64.5,50,66.1,2,0
10/21/2017 5:35,22,68.8,38,64.2,60,65.9,2,0
10/21/2017 5:40,20,68.9,36,64.2,56,65.9,2,0
10/21/2017 5:45,18,68.9,34,64.3,52,65.9,2,0
10/21/2017 5:50,16,69,32,64.4,48,65.9,2,0
10/21/2017 5:55,21,68.9,37,64.3,58,66,2,0
10/21/2017 6:00,18,69.1,33,64.4,51,66.1,2,0
10/21/2017 6:05,20,68.9,36,64.3,56,66,2,0
10/21/2017 6:10,26,69.2,41,64.6,67,66.4,2,0
10/21/2017 6:15,25,69.2,41,64.6,66,66.4,2,0
10/21/2017 6:20,24,69.3,40,64.7,64,66.4,2,0
10/21/2017 6:25,22,69.2,39,64.6,61,66.3,2,0
10/21/2017 6:30,23,69.2,39,64.5,62,66.3,2,0
10/21/2017 6:35,31,69.1,48,64.5,79,66.3,2,0
10/21/2017 6:40,36,69.6,54,65,90,66.8,2,0
10/21/2017 6:45,31,68.4,47,63.7,78,65.6,2,0
10/21/2017 6:50,30,68.8,47,64.2,77,66,2,0
10/21/2017 6:55,33,68.1,49,63.4,82,65.3,2,0
10/21/2017 7:00,31,67.5,48,62.7,79,64.5,2,0
10/21/2017 7:05,24,66.7,41,61.8,65,63.6,2,0
10/21/2017 7:10,36,67.3,53,62.6,89,64.5,2,0
10/21/2017 7:15,30,68.3,46,63.6,76,65.5,2,0
10/21/2017 7:20,34,69.5,51,64.9,85,66.7,2,0
10/21/2017 7:25,39,68.1,57,63.4,96,65.4,2,0
10/21/2017 7:30,34,68.7,51,64,85,65.9,2,0
10/21/2017 7:35,40,69,57,64.4,97,66.3,2,0
10/21/2017 7:40,44,69.3,61,64.7,105,66.6,2,0
10/21/2017 7:45,43,69,61,64.2,104,66.2,2,0
10/21/2017 7:50,38,69.9,55,65.3,93,67.2,2,0
10/21/2017 7:55,45,69.9,63,65.3,108,67.2,2,0
10/21/2017 8:00,46,69.1,64,64.5,110,66.4,2,0
10/21/2017 8:05,39,68.7,55,64.1,94,66,2,0
10/21/2017 8:10,38,69.6,54,65,92,66.9,2,0
10/21/2017 8:15,55,68.9,73,64.3,128,66.3,2,0
10/21/2017 8:20,48,70,66,65.4,114,67.4,2,0
10/21/2017 8:25,45,69.8,63,65.3,108,67.1,2,0
10/21/2017 8:30,50,70,67,65.5,117,67.5,2,0
10/21/2017 8:35,47,70.3,65,65.7,112,67.6,2,0
10/21/2017 8:40,52,70.1,71,65.6,123,67.5,2,0
10/21/2017 8:45,46,69.9,64,65.3,110,67.2,2,0
10/21/2017 8:50,43,69.6,60,65,103,66.9,2,0
10/21/2017 8:55,49,69.7,67,65.1,116,67.1,2,0
10/21/2017 9:00,41,70,59,65.5,100,67.4,2,0
10/21/2017 9:05,44,69.5,60,64.9,104,66.9,2,0
10/21/2017 9:10,44,68.8,61,64.2,105,66.1,2,0
10/21/2017 9:15,46,69.5,64,64.9,110,66.8,2,0
10/21/2017 9:20,55,68.7,73,64,128,66,2,0
10/21/2017 9:25,61,69.8,78,65.3,139,67.3,2,0
10/21/2017 9:30,60,68.9,78,64.3,138,66.3,2,0
10/21/2017 9:35,55,69.3,73,64.6,128,66.6,2,0
10/21/2017 9:40,54,69.1,73,64.5,127,66.4,2,0
10/21/2017 9:45,63,68.4,82,63.7,145,65.7,2,0
10/21/2017 9:50,65,69.7,84,65.1,149,67.1,2,0
10/21/2017 9:55,57,69.3,76,64.7,133,66.7,2,0
10/21/2017 10:00,53,68.4,71,63.8,124,65.8,2,0
10/21/2017 10:05,59,67.5,78,62.7,137,64.8,2,0
10/21/2017 10:10,62,67.9,80,63.1,142,65.2,2,0
10/21/2017 10:15,70,67.4,89,62.6,159,64.7,2,0
10/21/2017 10:20,60,67.9,79,63.1,139,65.2,2,0
10/21/2017 10:25,73,67,93,62.2,166,64.4,2,0
10/21/2017 10:30,70,67.2,90,62.4,160,64.5,2,0
10/21/2017 10:35,57,67.2,76,62.5,133,64.5,2,0
10/21/2017 10:40,75,68,96,63.4,171,65.4,2,0
10/21/2017 10:45,76,68.1,97,63.4,173,65.5,2,0
10/21/2017 10:50,76,68.5,97,63.8,173,65.8,2,0
10/21/2017 10:55,64,68.5,83,63.8,147,65.8,2,0
10/21/2017 11:00,61,68.8,81,64.2,142,66.2,2,0
10/21/2017 11:05,65,67,85,62.2,150,64.3,2,0
10/21/2017 11:10,61,68,80,63.2,141,65.3,2,0
10/21/2017 11:15,61,67.5,81,62.8,142,64.8,2,0
10/21/2017 11:20,64,68.3,84,63.6,148,65.6,2,0
10/21/2017 11:25,64,68.4,84,63.7,148,65.7,2,0
10/21/2017 11:30,57,68.3,75,63.7,132,65.7,2,0
10/21/2017 11:35,62,66.9,81,62.1,143,64.1,2,0
10/21/2017 11:40,60,67.3,78,62.5,138,64.6,2,0
10/21/2017 11:45,65,67.5,84,62.7,149,64.8,2,0
10/21/2017 11:50,59,66.8,78,62,137,64.1,2,0
10/21/2017 11:55,61,67.4,79,62.7,140,64.7,2,0
10/21/2017 12:00,61,68.3,80,63.6,141,65.6,2,0
10/21/2017 12:05,65,68.4,84,63.6,149,65.7,2,0
10/21/2017 12:10,61,68.1,81,63.4,142,65.4,2,0
10/21/2017 12:15,60,67.1,79,62.2,139,64.3,2,0
10/21/2017 12:20,67,67.1,86,62.2,153,64.3,2,0
10/21/2017 12:25,61,66.4,80,61.6,141,63.7,2,0
10/21/2017 12:30,59,67.5,78,62.7,137,64.7,2,0
10/21/2017 12:35,68,67.4,86,62.5,154,64.7,2,0
10/21/2017 12:40,63,67.9,82,63.2,145,65.2,2,0
10/21/2017 12:45,61,68.1,79,63.3,140,65.4,2,0
10/21/2017 12:50,61,67.9,80,63.2,141,65.2,2,0
10/21/2017 12:55,67,68.3,87,63.6,154,65.6,2,0
10/21/2017 13:00,66,68,85,63.3,151,65.3,2,0
10/21/2017 13:05,63,67.9,82,63.1,145,65.2,2,0
10/21/2017 13:10,55,66.4,73,61.5,128,63.6,2,0
10/21/2017 13:15,75,66.9,95,62.1,170,64.2,2,0
10/21/2017 13:20,58,67.2,77,62.4,135,64.4,2,0
10/21/2017 13:25,63,67.6,81,62.8,144,64.9,2,0
10/21/2017 13:30,67,67.7,86,62.9,153,65,2,0
10/21/2017 13:35,68,67.7,89,62.9,157,64.9,2,0
10/21/2017 13:40,63,66.9,82,62,145,64.1,2,0
10/21/2017 13:45,66,67.7,85,62.9,151,65,2,0
10/21/2017 13:50,68,67.1,87,62.2,155,64.4,2,0
10/21/2017 13:55,67,68,86,63.2,153,65.3,2,0
10/21/2017 14:00,67,68.4,85,63.7,152,65.8,2,0
10/21/2017 14:05,55,68.9,72,64.3,127,66.3,2,0
10/21/2017 14:10,59,68.2,77,63.5,136,65.5,2,0
10/21/2017 14:15,62,68,81,63.3,143,65.3,2,0
10/21/2017 14:20,59,68.5,77,63.9,136,65.9,2,0
10/21/2017 14:25,63,68.6,82,63.9,145,65.9,2,0
10/21/2017 14:30,59,69.3,76,64.7,135,66.7,2,0
10/21/2017 14:35,66,68.2,84,63.5,150,65.6,2,0
10/21/2017 14:40,67,67.4,86,62.6,153,64.7,2,0
10/21/2017 14:45,70,68.3,89,63.5,159,65.6,2,0
10/21/2017 14:50,60,67.6,78,62.8,138,64.9,2,0
10/21/2017 14:55,67,68.3,86,63.6,153,65.6,2,0
10/21/2017 15:00,60,69.1,79,64.5,139,66.5,2,0
10/21/2017 15:05,68,68.1,87,63.4,155,65.5,2,0
10/21/2017 15:10,64,68,83,63.2,147,65.3,2,0
10/21/2017 15:15,57,68.1,75,63.4,132,65.5,2,0
10/21/2017 15:20,55,67.9,73,63.1,128,65.2,2,0
10/21/2017 15:25,50,67.8,68,63,118,65,2,0
10/21/2017 15:30,58,66.8,76,61.9,134,64,2,0
10/21/2017 15:35,58,66.3,77,61.3,135,63.5,2,0
10/21/2017 15:40,63,67.1,81,62.2,144,64.3,2,0
10/21/2017 15:45,52,67.3,70,62.5,122,64.5,2,0
10/21/2017 15:50,56,66.9,74,62,130,64.1,2,0
10/21/2017 15:55,58,66.8,76,61.9,134,64,2,0
10/21/2017 16:00,56,67.2,75,62.4,131,64.5,2,0
10/21/2017 16:05,58,67.2,77,62.4,135,64.5,2,0
10/21/2017 16:10,62,67.2,80,62.4,142,64.5,2,0
10/21/2017 16:15,52,67.9,69,63.1,121,65.2,2,0
10/21/2017 16:20,54,68.1,72,63.4,126,65.4,2,0
10/21/2017 16:25,55,68.2,74,63.5,129,65.5,2,0
10/21/2017 16:30,53,67.6,72,62.8,125,64.9,2,0
10/21/2017 16:35,49,67.9,66,63.2,115,65.2,2,0
10/21/2017 16:40,46,67.9,63,63.1,109,65.2,2,0
10/21/2017 16:45,43,68,61,63.3,104,65.2,2,0
10/21/2017 16:50,43,68.2,60,63.5,103,65.5,2,0
10/21/2017 16:55,39,68.4,56,63.7,95,65.6,2,0
10/21/2017 17:00,37,68.9,54,64.3,91,66.2,2,0
10/21/2017 17:05,50,69.1,68,64.5,118,66.5,2,0
10/21/2017 17:10,53,68.5,71,63.7,124,65.8,2,0
10/21/2017 17:15,55,69.1,74,64.4,129,66.4,2,0
10/21/2017 17:20,47,68.7,64,64,111,66,2,0
10/21/2017 17:25,54,68.6,72,63.9,126,65.9,2,0
10/21/2017 17:30,54,68.6,73,63.9,127,65.9,2,0
10/21/2017 17:35,61,68.9,80,64.3,141,66.3,2,0
10/21/2017 17:40,70,68.8,90,64.1,160,66.1,2,0
10/21/2017 17:45,64,69,83,64.3,147,66.4,2,0
10/21/2017 17:50,52,68.8,70,64.1,122,66.1,2,0
10/21/2017 17:55,67,69.4,86,64.7,153,66.8,2,0
10/21/2017 18:00,61,68.8,80,64.1,141,66.1,2,0
10/21/2017 18:05,62,68.5,81,63.7,143,65.8,2,0
10/21/2017 18:10,63,68.7,81,64,144,66.1,2,0
10/21/2017 18:15,68,68.7,87,64,155,66,2,0
10/21/2017 18:20,65,69.3,84,64.7,149,66.7,2,0
10/21/2017 18:25,64,69.3,83,64.7,147,66.7,2,0
10/21/2017 18:30,60,68.8,79,64,139,66.1,2,0
10/21/2017 18:35,53,69.4,73,64.8,126,66.7,2,0
10/21/2017 18:40,64,69.3,83,64.6,147,66.7,2,0
10/21/2017 18:45,65,68.8,84,64,149,66.1,2,0
10/21/2017 18:50,64,69.1,83,64.4,147,66.5,2,0
10/21/2017 18:55,70,68.6,89,63.9,159,66,2,0
10/21/2017 19:00,60,68.2,78,63.4,138,65.5,2,0
10/21/2017 19:05,69,67.5,87,62.7,156,64.8,2,0
10/21/2017 19:10,55,68.3,72,63.6,127,65.7,2,0
10/21/2017 19:15,52,68.1,69,63.4,121,65.5,2,0
10/21/2017 19:20,52,68.4,70,63.7,122,65.7,2,0
10/21/2017 19:25,52,68.6,69,63.9,121,66,2,0
10/21/2017 19:30,64,68.9,83,64.2,147,66.2,2,0
10/21/2017 19:35,61,68.1,79,63.3,140,65.4,2,0
10/21/2017 19:40,54,68.3,73,63.6,127,65.6,2,0
10/21/2017 19:45,54,69.3,72,64.6,126,66.6,2,0
10/21/2017 19:50,45,69.6,61,65,106,67,2,0
10/21/2017 19:55,52,69.1,68,64.4,120,66.5,2,0
10/21/2017 20:00,50,69.6,67,65,117,67,2,0
10/21/2017 20:05,46,69.4,63,64.8,109,66.7,2,0
10/21/2017 20:10,46,70.1,63,65.5,109,67.5,2,0
10/21/2017 20:15,46,69.6,63,65,109,66.9,2,0
10/21/2017 20:20,47,68.9,65,64.2,112,66.1,2,0
10/21/2017 20:25,40,69.3,58,64.7,98,66.6,2,0
10/21/2017 20:30,42,68.6,59,63.9,101,65.9,2,0
10/21/2017 20:35,36,68.6,52,63.9,88,65.8,2,0
10/21/2017 20:40,41,69.4,58,64.8,99,66.7,2,0
10/21/2017 20:45,47,70,64,65.4,111,67.3,2,0
10/21/2017 20:50,43,69.7,60,65.1,103,67,2,0
10/21/2017 20:55,39,69.9,56,65.3,95,67.2,2,0
10/21/2017 21:00,37,69.4,54,64.8,91,66.6,2,0
10/21/2017 21:05,38,69.7,54,65.1,92,67,2,0
10/21/2017 21:10,38,69.3,54,64.7,92,66.6,2,0
10/21/2017 21:15,42,69.4,59,64.8,101,66.7,2,0
10/21/2017 21:20,46,69.6,63,65,109,67,2,0
10/21/2017 21:25,55,68.9,71,64.3,126,66.3,2,0
10/21/2017 21:30,53,68.4,71,63.7,124,65.7,2,0
10/21/2017 21:35,46,68.1,63,63.4,109,65.4,2,0
10/21/2017 21:40,49,68.4,67,63.7,116,65.7,2,0
10/21/2017 21:45,54,67.9,72,63.1,126,65.2,2,0
10/21/2017 21:50,48,68.3,66,63.5,114,65.5,2,0
10/21/2017 21:55,52,66.4,70,61.3,122,63.5,2,0
10/21/2017 22:00,50,66.8,67,61.8,117,63.9,2,0
10/21/2017 22:05,54,67.8,71,62.9,125,65,2,0
10/21/2017 22:10,51,68,68,63.2,119,65.3,2,0
10/21/2017 22:15,52,67.7,70,62.8,122,64.9,2,0
10/21/2017 22:20,43,68.3,60,63.6,103,65.6,2,0
10/21/2017 22:25,44,68.7,61,64,105,66,2,0
10/21/2017 22:30,42,68.7,59,64,101,66,2,0
10/21/2017 22:35,35,69.1,51,64.5,86,66.3,2,0
10/21/2017 22:40,30,69.5,45,64.9,75,66.7,2,0
10/21/2017 22:45,27,69.8,42,65.2,69,67,2,0
10/21/2017 22:50,33,69.4,50,64.8,83,66.7,2,0
10/21/2017 22:55,37,69.4,53,64.7,90,66.7,2,0
10/21/2017 23:00,31,69.3,47,64.7,78,66.5,2,0
10/21/2017 23:05,26,69.7,41,65.1,67,66.9,2,0
10/21/2017 23:10,29,70.1,44,65.5,73,67.3,2,0
10/21/2017 23:15,27,69.8,43,65.2,70,67,2,0
10/21/2017 23:20,26,69.5,42,64.9,68,66.6,2,0
10/21/2017 23:25,29,69.2,45,64.6,74,66.4,2,0
10/21/2017 23:30,19,69.3,34,64.7,53,66.4,2,0
10/21/2017 23:35,24,69.3,40,64.7,64,66.4,2,0
10/21/2017 23:40,24,68.4,39,63.8,63,65.6,2,0
10/21/2017 23:45,26,68.6,41,64,67,65.8,2,0
10/21/2017 23:50,21,68.7,36,64.1,57,65.8,2,0
10/21/2017 23:55,19,69.2,34,64.5,53,66.2,2,0
10/22/2017 0:00,19,69.2,35,64.5,54,66.2,2,0
10/22/2017 0:05,18,69.1,34,64.5,52,66.1,2,0
10/22/2017 0:10,19,68.8,34,64.1,53,65.8,2,0
10/22/2017 0:15,17,69.1,32,64.5,49,66.1,2,0
10/22/2017 0:20,18,69.3,34,64.7,52,66.3,2,0
10/22/2017 0:25,16,69.3,31,64.7,47,66.3,2,0
10/22/2017 0:30,18,69.3,33,64.7,51,66.3,2,0
10/22/2017 0:35,18,69.1,33,64.5,51,66.1,2,0
10/22/2017 0:40,13,69.2,28,64.5,41,66,2,0
10/22/2017 0:45,10,69.3,25,64.7,35,66,2,0
10/22/2017 0:50,12,69.1,27,64.5,39,65.9,2,0
10/22/2017 0:55,11,69.2,27,64.6,38,66,2,0
10/22/2017 1:00,14,69.4,29,64.8,43,66.3,2,0
10/22/2017 1:05,10,69.2,26,64.5,36,65.8,2,0
10/22/2017 1:10,10,69.3,25,64.7,35,66,2,0
10/22/2017 1:15,9,69.2,24,64.6,33,65.9,2,0
10/22/2017 1:20,9,69.4,24,64.8,33,66,2,0
10/22/2017 1:25,10,69.3,26,64.7,36,66,2,0
10/22/2017 1:30,12,69.4,26,64.8,38,66.2,2,0
10/22/2017 1:35,10,69.4,25,64.8,35,66.1,2,0
10/22/2017 1:40,10,69.4,25,64.8,35,66.1,2,0
10/22/2017 1:45,13,69.3,28,64.7,41,66.2,2,0
10/22/2017 1:50,10,69.4,25,64.8,35,66.1,2,0
10/22/2017 1:55,10,69.4,25,64.8,35,66.1,2,0
10/22/2017 2:00,11,69.4,26,64.8,37,66.1,2,0
10/22/2017 2:05,14,69.3,30,64.7,44,66.1,2,0
10/22/2017 2:10,8,69.3,23,64.7,31,65.9,2,0
10/22/2017 2:15,8,69.3,23,64.7,31,65.9,2,0
10/22/2017 2:20,10,69.3,25,64.7,35,66,2,0
10/22/2017 2:25,10,69.3,26,64.7,36,65.9,2,0
10/22/2017 2:30,8,69.3,24,64.7,32,65.9,2,0
10/22/2017 2:35,8,69.3,23,64.7,31,65.9,2,0
10/22/2017 2:40,8,69.4,24,64.8,32,65.9,2,0
10/22/2017 2:45,6,69.3,22,64.7,28,65.7,2,0
10/22/2017 2:50,5,69.3,20,64.7,25,65.6,2,0
10/22/2017 2:55,8,69.4,23,64.8,31,66,2,0
10/22/2017 3:00,9,69.4,24,64.8,33,66.1,2,0
10/22/2017 3:05,10,69.3,26,64.7,36,66,2,0
10/22/2017 3:10,13,69.3,28,64.7,41,66.1,2,0
10/22/2017 3:15,8,69.3,23,64.7,31,65.9,2,0
10/22/2017 3:20,8,69.4,23,64.8,31,66,2,0
10/22/2017 3:25,8,69.3,23,64.7,31,65.9,2,0
10/22/2017 3:30,8,69.3,24,64.7,32,65.9,2,0
10/22/2017 3:35,15,69.3,22,64.7,37,66.6,2,0
10/22/2017 3:40,6,69.4,21,64.7,27,65.8,2,0
10/22/2017 3:45,9,69.3,25,64.7,34,66,2,0
10/22/2017 3:50,8,69.4,23,64.8,31,66,2,0
10/22/2017 3:55,14,69.3,22,64.7,36,66.5,2,0
10/22/2017 4:00,11,69.4,26,64.8,37,66.1,2,0
10/22/2017 4:05,8,69.2,23,64.5,31,65.7,2,0
10/22/2017 4:10,12,69.3,21,64.7,33,66.3,2,0
10/22/2017 4:15,9,69.3,24,64.7,33,66,2,0
10/22/2017 4:20,5,69.3,21,64.7,26,65.6,2,0
10/22/2017 4:25,10,69.2,25,64.6,35,65.9,2,0
10/22/2017 4:30,11,69.3,27,64.7,38,66.1,2,0
10/22/2017 4:35,7,69.3,22,64.7,29,65.8,2,0
10/22/2017 4:40,11,69.3,27,64.7,38,66,2,0
10/22/2017 4:45,17,69.3,33,64.7,50,66.3,2,0
10/22/2017 4:50,14,69.3,30,64.7,44,66.1,2,0
10/22/2017 4:55,13,69.3,28,64.7,41,66.2,2,0
10/22/2017 5:00,16,69.4,32,64.8,48,66.3,2,0
10/22/2017 5:05,12,69.4,27,64.8,39,66.2,2,0
10/22/2017 5:10,15,69.4,31,64.7,46,66.2,2,0
10/22/2017 5:15,11,69.2,26,64.6,37,66,2,0
10/22/2017 5:20,11,69.3,26,64.7,37,66,2,0
10/22/2017 5:25,19,69.4,35,64.8,54,66.4,2,0
10/22/2017 5:30,14,69.2,30,64.5,44,66,2,0
10/22/2017 5:35,15,69.3,30,64.7,45,66.2,2,0
10/22/2017 5:40,17,69.5,33,64.9,50,66.5,2,0
10/22/2017 5:45,14,69.3,29,64.7,43,66.2,2,0
10/22/2017 5:50,13,69.3,29,64.7,42,66.1,2,0
10/22/2017 5:55,13,69.4,29,64.8,42,66.2,2,0
10/22/2017 6:00,16,69.3,32,64.7,48,66.3,2,0
10/22/2017 6:05,14,69.4,30,64.8,44,66.3,2,0
10/22/2017 6:10,19,69,35,64.4,54,66,2,0
10/22/2017 6:15,12,69.3,27,64.7,39,66.1,2,0
10/22/2017 6:20,17,69.3,32,64.7,49,66.3,2,0
10/22/2017 6:25,19,69.3,35,64.7,54,66.3,2,0
10/22/2017 6:30,17,69.3,33,64.7,50,66.3,2,0
10/22/2017 6:35,16,69.4,32,64.8,48,66.3,2,0
10/22/2017 6:40,17,69.5,32,64.9,49,66.5,2,0
10/22/2017 6:45,22,69.4,37,64.8,59,66.5,2,0
10/22/2017 6:50,18,69.3,33,64.7,51,66.3,2,0
10/22/2017 6:55,16,69.3,31,64.7,47,66.2,2,0
10/22/2017 7:00,23,69.2,39,64.6,62,66.3,2,0
10/22/2017 7:05,16,69.1,32,64.5,48,66,2,0
10/22/2017 7:10,20,69,35,64.4,55,66,2,0
10/22/2017 7:15,26,69,41,64.4,67,66.2,2,0
10/22/2017 7:20,24,69.3,39,64.7,63,66.5,2,0
10/22/2017 7:25,21,69.2,37,64.6,58,66.3,2,0
10/22/2017 7:30,24,68.7,40,64,64,65.8,2,0
10/22/2017 7:35,21,68.6,36,64,57,65.7,2,0
10/22/2017 7:40,29,69,46,64.3,75,66.1,2,0
10/22/2017 7:45,29,68.8,45,64.2,74,66,2,0
10/22/2017 7:50,32,69.1,48,64.5,80,66.4,2,0
10/22/2017 7:55,31,69.4,47,64.8,78,66.6,2,0
10/22/2017 8:00,30,69.3,46,64.7,76,66.5,2,0
10/22/2017 8:05,26,69,42,64.4,68,66.2,2,0
10/22/2017 8:10,34,69,50,64.3,84,66.2,2,0
10/22/2017 8:15,26,69.1,41,64.5,67,66.3,2,0
10/22/2017 8:20,42,68.7,59,64,101,65.9,2,0
10/22/2017 8:25,32,68.8,48,64.1,80,66,2,0
10/22/2017 8:30,33,69.1,48,64.4,81,66.3,2,0
10/22/2017 8:35,35,68.7,51,64.1,86,66,2,0
10/22/2017 8:40,38,69,55,64.4,93,66.3,2,0
10/22/2017 8:45,38,69.1,55,64.4,93,66.3,2,0
10/22/2017 8:50,35,68.8,52,64.1,87,66,2,0
10/22/2017 8:55,34,68.9,51,64.3,85,66.2,2,0
10/22/2017 9:00,34,69.6,50,65,84,66.8,2,0
10/22/2017 9:05,34,69.6,51,65,85,66.8,2,0
10/22/2017 9:10,41,69.2,58,64.6,99,66.5,2,0
10/22/2017 9:15,46,69.1,63,64.4,109,66.4,2,0
10/22/2017 9:20,44,68.5,61,63.8,105,65.7,2,0
10/22/2017 9:25,48,67.8,65,63.1,113,65.1,2,0
10/22/2017 9:30,42,68.1,59,63.4,101,65.4,2,0
10/22/2017 9:35,48,69.1,64,64.5,112,66.5,2,0
10/22/2017 9:40,49,68.8,67,64,116,66,2,0
10/22/2017 9:45,47,69,64,64.4,111,66.3,2,0
10/22/2017 9:50,59,68.5,78,63.8,137,65.8,2,0
10/22/2017 9:55,49,68.7,66,64,115,66,2,0
10/22/2017 10:00,48,69,65,64.3,113,66.3,2,0
10/22/2017 10:05,47,69.2,64,64.5,111,66.5,2,0
10/22/2017 10:10,54,68.9,73,64.3,127,66.2,2,0
10/22/2017 10:15,50,69,68,64.3,118,66.3,2,0
10/22/2017 10:20,53,68.9,71,64.2,124,66.2,2,0
10/22/2017 10:25,57,68.1,75,63.4,132,65.4,2,0
10/22/2017 10:30,58,68.7,76,64,134,66,2,0
10/22/2017 10:35,56,68.6,74,63.9,130,65.9,2,0
10/22/2017 10:40,60,69,79,64.4,139,66.4,2,0
10/22/2017 10:45,56,69.5,75,64.9,131,66.9,2,0
10/22/2017 10:50,61,69.9,79,65.3,140,67.3,2,0
10/22/2017 10:55,65,68.8,85,64.2,150,66.2,2,0
10/22/2017 11:00,61,68.6,79,63.9,140,65.9,2,0
10/22/2017 11:05,68,68.1,88,63.4,156,65.5,2,0
10/22/2017 11:10,67,68.6,86,63.9,153,66,2,0
10/22/2017 11:15,51,68.9,69,64.3,120,66.3,2,0
10/22/2017 11:20,63,68.9,82,64.2,145,66.2,2,0
10/22/2017 11:25,60,69.7,78,65.1,138,67.1,2,0
10/22/2017 11:30,63,69.2,82,64.5,145,66.6,2,0
10/22/2017 11:35,64,68.7,83,64,147,66.1,2,0
10/22/2017 11:40,63,69.2,82,64.6,145,66.6,2,0
10/22/2017 11:45,72,69,92,64.4,164,66.4,2,0
10/22/2017 11:50,56,69.2,73,64.6,129,66.6,2,0
10/22/2017 11:55,69,67.9,88,63.2,157,65.3,2,0
10/22/2017 12:00,59,68.1,77,63.3,136,65.4,2,0
10/22/2017 12:05,67,68.5,87,63.8,154,65.9,2,0
10/22/2017 12:10,63,68.9,82,64.2,145,66.2,2,0
10/22/2017 12:15,60,68.4,78,63.8,138,65.8,2,0
10/22/2017 12:20,66,69,84,64.4,150,66.4,2,0
10/22/2017 12:25,64,68.5,82,63.9,146,65.9,2,0
10/22/2017 12:30,71,68.5,91,63.8,162,65.8,2,0
10/22/2017 12:35,60,68.7,78,64,138,66,2,0
10/22/2017 12:40,59,68.6,78,63.9,137,65.9,2,0
10/22/2017 12:45,62,68.5,82,63.9,144,65.9,2,0
10/22/2017 12:50,58,68.5,77,63.9,135,65.9,2,0
10/22/2017 12:55,59,67.8,77,63.1,136,65.1,2,0
10/22/2017 13:00,59,68.4,77,63.6,136,65.7,2,0
10/22/2017 13:05,52,69.1,69,64.4,121,66.5,2,0
10/22/2017 13:10,63,69.7,82,65.1,145,67.1,2,0
10/22/2017 13:15,60,69,79,64.3,139,66.3,2,0
10/22/2017 13:20,66,69.1,84,64.4,150,66.5,2,0
10/22/2017 13:25,68,68.7,87,64,155,66,2,0
10/22/2017 13:30,59,69.3,76,64.7,135,66.7,2,0
10/22/2017 13:35,63,69.6,82,65,145,67,2,0
10/22/2017 13:40,62,69,80,64.3,142,66.3,2,0
10/22/2017 13:45,63,69.3,82,64.7,145,66.7,2,0
10/22/2017 13:50,69,69.1,88,64.5,157,66.5,2,0
10/22/2017 13:55,66,69.6,85,65,151,67,2,0
10/22/2017 14:00,60,69.3,78,64.7,138,66.7,2,0
10/22/2017 14:05,68,68.7,88,64,156,66.1,2,0
10/22/2017 14:10,61,68.6,79,63.8,140,65.9,2,0
10/22/2017 14:15,60,68.9,78,64.2,138,66.3,2,0
10/22/2017 14:20,75,68.7,94,63.9,169,66,2,0
10/22/2017 14:25,60,68.8,78,64.1,138,66.1,2,0
10/22/2017 14:30,60,68.6,79,63.8,139,65.9,2,0
10/22/2017 14:35,59,68.2,77,63.4,136,65.5,2,0
10/22/2017 14:40,59,68.7,78,63.9,137,66,2,0
10/22/2017 14:45,66,68.1,85,63.2,151,65.3,2,0
10/22/2017 14:50,62,69.6,80,64.9,142,67,2,0
10/22/2017 14:55,68,69.2,87,64.6,155,66.6,2,0
10/22/2017 15:00,67,69.2,86,64.5,153,66.6,2,0
10/22/2017 15:05,63,68.6,81,63.9,144,66,2,0
10/22/2017 15:10,67,69,86,64.4,153,66.4,2,0
10/22/2017 15:15,56,69.1,74,64.4,130,66.4,2,0
10/22/2017 15:20,64,69,83,64.4,147,66.4,2,0
10/22/2017 15:25,60,69.6,78,65,138,67,2,0
10/22/2017 15:30,57,69.2,75,64.5,132,66.5,2,0
10/22/2017 15:35,61,69.5,80,64.9,141,66.9,2,0
10/22/2017 15:40,60,69.5,79,64.9,139,66.9,2,0
10/22/2017 15:45,55,69.6,75,65.1,130,67,2,0
10/22/2017 15:50,57,69.2,75,64.6,132,66.6,2,0
10/22/2017 15:55,57,69,75,64.4,132,66.4,2,0
10/22/2017 16:00,63,69.4,81,64.8,144,66.8,2,0
10/22/2017 16:05,53,68.9,70,64.3,123,66.2,2,0
10/22/2017 16:10,58,69.4,76,64.9,134,66.9,2,0
10/22/2017 16:15,63,69.8,81,65.3,144,67.3,2,0
10/22/2017 16:20,56,70,74,65.4,130,67.4,2,0
10/22/2017 16:25,64,69.4,82,64.9,146,66.9,2,0
10/22/2017 16:30,54,69.5,73,65,127,66.9,2,0
10/22/2017 16:35,55,69.3,74,64.7,129,66.6,2,0
10/22/2017 16:40,62,68.7,79,64,141,66.1,2,0
10/22/2017 16:45,50,68.5,67,63.8,117,65.8,2,0
10/22/2017 16:50,67,67.9,88,63.1,155,65.2,2,0
10/22/2017 16:55,62,68,81,63.2,143,65.3,2,0
10/22/2017 17:00,61,67.6,80,62.8,141,64.9,2,0
10/22/2017 17:05,62,67.6,80,62.7,142,64.9,2,0
10/22/2017 17:10,67,68.1,86,63.3,153,65.4,2,0
10/22/2017 17:15,68,68,87,63.3,155,65.4,2,0
10/22/2017 17:20,70,67.5,89,62.7,159,64.9,2,0
10/22/2017 17:25,63,68.4,82,63.7,145,65.8,2,0
10/22/2017 17:30,68,68,87,63.2,155,65.3,2,0
10/22/2017 17:35,74,67.7,93,62.9,167,65,2,0
10/22/2017 17:40,58,68.1,77,63.3,135,65.4,2,0
10/22/2017 17:45,66,68,84,63.2,150,65.3,2,0
10/22/2017 17:50,66,67.5,85,62.7,151,64.8,2,0
10/22/2017 17:55,66,66.8,84,61.9,150,64.1,2,0
10/22/2017 18:00,56,68,74,63.3,130,65.4,2,0
10/22/2017 18:05,57,68.2,76,63.5,133,65.5,2,0
10/22/2017 18:10,60,69.2,79,64.5,139,66.5,2,0
10/22/2017 18:15,47,69.3,66,64.7,113,66.6,2,0
10/22/2017 18:20,54,69.4,72,64.8,126,66.8,2,0
10/22/2017 18:25,49,69.6,67,65,116,67,2,0
10/22/2017 18:30,51,69.5,68,64.9,119,66.9,2,0
10/22/2017 18:35,53,69.7,71,65.2,124,67.1,2,0
10/22/2017 18:40,40,69.8,57,65.2,97,67.1,2,0
10/22/2017 18:45,49,69.4,67,64.7,116,66.7,2,0
10/22/2017 18:50,54,68.9,72,64.2,126,66.2,2,0
10/22/2017 18:55,54,68.6,72,63.9,126,65.9,2,0
10/22/2017 19:00,50,68.4,68,63.6,118,65.6,2,0
10/22/2017 19:05,51,68.6,68,63.9,119,65.9,2,0
10/22/2017 19:10,50,68.8,68,64.1,118,66.1,2,0
10/22/2017 19:15,51,69.4,68,64.8,119,66.8,2,0
10/22/2017 19:20,47,69.3,64,64.7,111,66.6,2,0
10/22/2017 19:25,46,69.6,63,64.9,109,66.9,2,0
10/22/2017 19:30,43,69.2,61,64.6,104,66.5,2,0
10/22/2017 19:35,42,69.2,59,64.5,101,66.5,2,0
10/22/2017 19:40,45,69,62,64.4,107,66.3,2,0
10/22/2017 19:45,46,68.6,63,63.9,109,65.9,2,0
10/22/2017 19:50,47,69.1,64,64.5,111,66.5,2,0
10/22/2017 19:55,40,69.3,57,64.7,97,66.6,2,0
10/22/2017 20:00,38,69.5,56,65,94,66.8,2,0
10/22/2017 20:05,36,69.4,52,64.8,88,66.7,2,0
10/22/2017 20:10,29,68.8,45,64.1,74,65.9,2,0
10/22/2017 20:15,29,68.7,46,64.1,75,65.9,2,0
10/22/2017 20:20,31,68.8,48,64.1,79,66,2,0
10/22/2017 20:25,25,69.4,41,64.8,66,66.5,2,0
10/22/2017 20:30,27,69.3,42,64.7,69,66.5,2,0
10/22/2017 20:35,28,69.4,45,64.8,73,66.6,2,0
10/22/2017 20:40,27,69.5,43,64.9,70,66.6,2,0
10/22/2017 20:45,25,69.2,41,64.6,66,66.4,2,0
10/22/2017 20:50,25,69,41,64.3,66,66.1,2,0
10/22/2017 20:55,24,69.2,41,64.5,65,66.2,2,0
10/22/2017 21:00,28,68.7,45,64,73,65.8,2,0
10/22/2017 21:05,21,68.8,37,64.1,58,65.8,2,0
10/22/2017 21:10,17,69.1,32,64.5,49,66.1,2,0
10/22/2017 21:15,22,69.3,38,64.7,60,66.4,2,0
10/22/2017 21:20,22,69.2,38,64.5,60,66.2,2,0
10/22/2017 21:25,24,68.9,40,64.3,64,66,2,0
10/22/2017 21:30,21,69.2,37,64.6,58,66.3,2,0
10/22/2017 21:35,27,69.7,43,65.1,70,66.8,2,0
10/22/2017 21:40,22,69.5,38,64.9,60,66.6,2,0
10/22/2017 21:45,21,69.4,36,64.8,57,66.5,2,0
10/22/2017 21:50,20,69.3,36,64.7,56,66.3,2,0
10/22/2017 21:55,19,69.4,35,64.7,54,66.4,2,0
10/22/2017 22:00,24,69.4,40,64.7,64,66.5,2,0
10/22/2017 22:05,23,69,39,64.4,62,66.1,2,0
10/22/2017 22:10,22,69.1,37,64.5,59,66.2,2,0
10/22/2017 22:15,23,69.2,39,64.6,62,66.3,2,0
10/22/2017 22:20,22,69.2,38,64.6,60,66.3,2,0
10/22/2017 22:25,24,68.9,40,64.3,64,66,2,0
10/22/2017 22:30,28,67.7,44,63,72,64.8,2,0
10/22/2017 22:35,22,68.4,37,63.7,59,65.4,2,0
10/22/2017 22:40,21,69,37,64.3,58,66,2,0
10/22/2017 22:45,24,68.9,40,64.3,64,66,2,0
10/22/2017 22:50,20,68.9,36,64.3,56,65.9,2,0
10/22/2017 22:55,21,69.1,36,64.4,57,66.1,2,0
10/22/2017 23:00,18,69.2,34,64.6,52,66.2,2,0
10/22/2017 23:05,20,69.2,36,64.5,56,66.2,2,0
10/22/2017 23:10,21,69.2,37,64.6,58,66.2,2,0
10/22/2017 23:15,19,69.3,35,64.7,54,66.3,2,0
10/22/2017 23:20,13,69.4,28,64.7,41,66.2,2,0
10/22/2017 23:25,15,69.3,31,64.7,46,66.2,2,0
10/22/2017 23:30,14,69.3,30,64.7,44,66.2,2,0
10/22/2017 23:35,15,69.4,30,64.8,45,66.3,2,0
10/22/2017 23:40,16,69.2,31,64.6,47,66.2,2,0
10/22/2017 23:45,18,69.3,33,64.7,51,66.3,2,0
10/22/2017 23:50,16,69.4,31,64.8,47,66.3,2,0
10/22/2017 23:55,13,69.1,29,64.5,42,65.9,2,0
